MsgBackupCreateLocation=如果您在可執行文件所在的文件夾中創建名為“{0}”的文件夾，NHSE 可以執行自動備份。
MsgBackupCreateQuestion=您是否希望 NHSE 自動保留您保存數據的備份？
MsgDataSizeMismatchImport=導入文件的大小 (0x{0:X}) 與所需的大小 (0x{1:X}) 不匹配。
MsgDataSizeMismatchRAM=讀取大小 (0x{0:X}) != 寫入大小 (0x{1:X})。
MsgDataDidNotOriginateFromHost_0=導入的數據並非來自 Villager0 ({0}) 的數據。
MsgAskUpdateValues=更新值？
MsgAskContinue=繼續？
MsgAskWriteAnyway=還是寫？
MsgAskExportResultToClipboard=將結果導出到剪貼板？
MsgCanceling=取消：
MsgInvalidHexValue=錯誤的十六進制值。
MsgImportDirectoryDoesNotExist=目錄不存在！
MsgNoPictureLoaded=未加載圖片。
MsgSaveDataImportFail=無法打開包含保存文件的文件夾。
MsgSaveDataImportSuggest=嘗試將其移動到另一個位置並從那裡打開。
MsgSaveDataExportSuccess=已保存所有保存數據！
MsgSaveDataExportFail=無法將文件保存到其原始位置。
MsgSaveDataHashesValid=哈希有效。
MsgSaveDataSizeMismatch=保存文件大小似乎不正確。
MsgMoveOut=你想讓村民搬走嗎？
MsgMoveOutSuggest=如果是這樣，將事件標誌 (024 - ForceMoveOut) 設置為 1，以便遊戲移除村民。
MsgFieldItemRemoveAsk=您確定要刪除{0}嗎？
MsgFieldItemRemoveNone=未刪除任何內容（未找到）。
MsgFieldItemRemoveCount=從地圖中刪除了 {0}。
MsgFieldItemModifyAsk=您確定要{0}嗎？
MsgFieldItemModifyNone=未修改任何內容（未找到）。
MsgFieldItemModifyCount=修改了地圖上的 {0} 個圖塊。
MsgFieldItemUnsupportedLayer2Tile=檢測到不支持的第 2 層項目。
MsgSysBotInfo=當調用讀/寫時，此 SysBot 會直接將 RAM 讀取和寫入您的遊戲。
MsgSysBotRequired=使用此功能需要在控制台上運行 sys-botbase sysmodule。您的控制台必須與運行此程序的 PC 位於同一網絡上。
MsgTerrainSetElevation0=將地圖上所有圖塊的高程設置為 0？
MsgTerrainSetAll=將圖塊編輯器中的圖塊設置為地圖上的所有圖塊？
MsgTerrainSetAllSkipExterior=您想跳過外部英畝（海灘/岩石）中的瓷磚嗎？
MsgVillagerFriendshipMax=你想把所有村民友誼記憶設為255嗎？
MsgMoveOutAll=這將為所有村民勾選“搬出”框。
MsgFieldItemNoNHI=沒有選擇要導入的 .nhi 文件！
MsgVillagerReplaceNoText=剪貼板：未找到文本！預期的內部村民姓名。
MsgVillagerReplaceOutdatedSaveFormat=保存文件不是最新的村民格式。請在遊戲中更新。
MsgVillagerReplaceUnknownName=剪貼板：{0} 不是有效的內部村民名稱。
