CatchFish=CatchFish
CatchInsect=CatchInsect
CatchFishContinuously=CatchFishContinuously
FillFishList=FillFishList
FillInsectList=FillInsectList
ShootDownBalloon=ShootDownBalloon
PlantFlowerSeed=PlantFlowerSeed
PlantFruit=PlantFruit
PlantTreeSeedling=PlantTreeSeedling
BuyKabu=BuyKabu
HowmuchSellKabu=HowmuchSellKabu
HowmuchBuyItem=HowmuchBuyItem
BuyItemRcm=BuyItemRcm
SellItemRcm=SellItemRcm
RemakeFurniture=RemakeFurniture
FillCatalog=FillCatalog
BuyItemCatalog=BuyItemCatalog
GotoTotakekeShow=GotoTotakekeShow
VisitAnotherIsland=VisitAnotherIsland
InviteFriend=InviteFriend
DayPlayed=DayPlayed
WaterPlant=WaterPlant
BeStungbyWasp=BeStungbyWasp
CatchSeminonukegara=CatchSeminonukegara
CatchNomi=CatchNomi
BeStungbyPoisonousInsect=BeStungbyPoisonousInsect
FillReactionList=FillReactionList
CatchTrash=CatchTrash
PayImmigrationCost=PayImmigrationCost
RepayLoan=RepayLoan
UseMydesign=UseMydesign
UseMydesignPRO=UseMydesignPRO
SellWeed=SellWeed
CollectGoldTool=CollectGoldTool
GetSRankonHHA=GetSRankonHHA
AttendFishingConvention=AttendFishingConvention
AttendInsectConvention=AttendInsectConvention
HelpGul=HelpGul
HelpGst=HelpGst
MakePerfectSnowball=MakePerfectSnowball
ReachMyBirthday=ReachMyBirthday
CelebrateVillagersBithday=CelebrateVillagersBithday
AttendCountdownParty=AttendCountdownParty
BreakTool=BreakTool
SendLetter=SendLetter
MakePitfall=MakePitfall
FallintoPitfall=FallintoPitfall
ImmigratetoIsland=ImmigratetoIsland
BeFriendwithVillager=BeFriendwithVillager
FillRecipeList=FillRecipeList
BootPhone=BootPhone
StrikeRock8Times=StrikeRock8Times
AchieveAppQuest=AchieveAppQuest
AchieveVillagersQuest=AchieveVillagersQuest
DigBell=DigBell
DigFossil=DigFossil
JudgeFossil=JudgeFossil
DigShell=DigShell
PutFurnitureOutside=PutFurnitureOutside
StrikeWood=StrikeWood
GreetAllVillager=GreetAllVillager
SellShell=SellShell
SellFruit=SellFruit
CatchBeeContinuously=CatchBeeContinuously
DIYTool=DIYTool
DIYFurniture=DIYFurniture
TakePicture=TakePicture
BootPhoneBeginner=BootPhoneBeginner
HouseStorageItem=HouseStorageItem
PlaceFurnitureMyHouse=PlaceFurnitureMyHouse
FallFurnitureLeaf=FallFurnitureLeaf
DropPresentinWater=DropPresentinWater
ReformMyHome=ReformMyHome
ExtendMyHome=ExtendMyHome
PostMessageBoard=PostMessageBoard
UseCloset=UseCloset
PrayShootingStar=PrayShootingStar
ChangeSymbol=ChangeSymbol
UpdatePassport=UpdatePassport
ModifyIsland=ModifyIsland
BuildFence=BuildFence
DonateFake=DonateFake
BuyatTsunekichiShop=BuyatTsunekichiShop
PlantBushSeedling=PlantBushSeedling
FillSeafoodList=FillSeafoodList
GiveScallopsToSeo=GiveScallopsToSeo
CatchSeafood=CatchSeafood
PrologueNpcHintCount=PrologueNpcHintCount
TotakekeLiveCount=TotakekeLiveCount
JohnnyQuestStartFlag=JohnnyQuestStartFlag
JohnnyQuestFinishFlag=JohnnyQuestFinishFlag
JonnyTalkCount=JonnyTalkCount
HasPlayedTreasureHunt=HasPlayedTreasureHunt
ShizueCmnExplanationTowntune=ShizueCmnExplanationTowntune
ShizueCmnExplanationTownflag=ShizueCmnExplanationTownflag
ShizueCmnExplanationComplaint=ShizueCmnExplanationComplaint
FutaTalkedWhenAsleep=FutaTalkedWhenAsleep
FutaExplanationDonationComp=FutaExplanationDonationComp
FutaTalkedInMuseumToday=FutaTalkedInMuseumToday
FutaHeardCommentary=FutaHeardCommentary
FutaReadyForMuseum=FutaReadyForMuseum
FutaReadyForMuseumToday=FutaReadyForMuseumToday
KaburibaTalkTodayFlag=KaburibaTalkTodayFlag
KaburibaTalkBeforeFlag=KaburibaTalkBeforeFlag
KaburibaBuyKabuTodayFlag=KaburibaBuyKabuTodayFlag
KinuyoTalkBoforeFlag=KinuyoTalkBoforeFlag
KinuyoTalkTodayFlag=KinuyoTalkTodayFlag
SkkTalkBeforeFlag=SkkTalkBeforeFlag
ReijiTalkBeforeFlag=ReijiTalkBeforeFlag
RollanTalkTodayFlag=RollanTalkTodayFlag
RollanBuyLargeCount=RollanBuyLargeCount
RollanBuyMediumCount=RollanBuyMediumCount
RollanBuySmallCount=RollanBuySmallCount
RcmTalkBeforeFlag=RcmTalkBeforeFlag
RcmTookReqMarket=RcmTookReqMarket
RcmDeclinedMarketReq=RcmDeclinedMarketReq
DoneCharacterCreation=DoneCharacterCreation
RcmNoTurnipSellToday=RcmNoTurnipSellToday
ValidatePlayerSaveFlag=ValidatePlayerSaveFlag
MakeVillagePlayerFlag=MakeVillagePlayerFlag
PrologueDone1stTalkAtPlaza=PrologueDone1stTalkAtPlaza
HighAndLowPlayed=HighAndLowPlayed
HappyHomeMission1=HappyHomeMission1
OccurrenceCoinStone=OccurrenceCoinStone
HappyHomeMission2=HappyHomeMission2
SeoRejectFlag=SeoRejectFlag
HappyHomeMission3=HappyHomeMission3
CatchFishFesCount=CatchFishFesCount
CatchInsectFesCount=CatchInsectFesCount
PlayerPocketUIEnable=PlayerPocketUIEnable
PlayerMainUImenuEnable=PlayerMainUImenuEnable
Prologue4AfterBuiltPcTent=Prologue4AfterBuiltPcTent
RcoHearedWhatShouldIAsk=RcoHearedWhatShouldIAsk
Prologue4OwlNoMuseum=Prologue4OwlNoMuseum
Prologue4OwlGetTent=Prologue4OwlGetTent
Prologue4OwlBuiltMuseum=Prologue4OwlBuiltMuseum
Prologue4RcmNoShop=Prologue4RcmNoShop
Prologue4RcmGetTent=Prologue4RcmGetTent
Prologue4RcmBuiltShop=Prologue4RcmBuiltShop
Prologue4HaNoTent=Prologue4HaNoTent
Prologue4HaGetTent=Prologue4HaGetTent
Prologue4HaBuiltTent=Prologue4HaBuiltTent
Prologue4AnNoTent=Prologue4AnNoTent
Prologue4AnGetTent=Prologue4AnGetTent
Prologue4AnBuiltTent=Prologue4AnBuiltTent
BirthdayNGavePresentFlag=BirthdayNGavePresentFlag
BirthdayPCandleFlag=BirthdayPCandleFlag
BirthdayPNotPresentFlag=BirthdayPNotPresentFlag
SickQuestFirst=SickQuestFirst
TotakekeTalkBeforeFlag=TotakekeTalkBeforeFlag
JohnnyTalkBeforeFlag=JohnnyTalkBeforeFlag
KotonoTalkBeforeFlag=KotonoTalkBeforeFlag
RollanTalkBeforeFlag=RollanTalkBeforeFlag
TunekichiTalkBefore=TunekichiTalkBefore
KotonoQuestCount=KotonoQuestCount
KotonoQuestStartFlag=KotonoQuestStartFlag
KotonoQuestClearFlag=KotonoQuestClearFlag
KotonoQuestRefuseFlag=KotonoQuestRefuseFlag
MainmenuEncyclopedia=MainmenuEncyclopedia
MainmenuMap=MainmenuMap
MainmenuMydesign=MainmenuMydesign
MainmenuBank=MainmenuBank
RcmTalked1P1stday=RcmTalked1P1stday
HappyHomeMission4=HappyHomeMission4
RcoHeardDetailDIYtrial=RcoHeardDetailDIYtrial
SzaTaled1stTime=SzaTaled1stTime
HappyHomeMission5=HappyHomeMission5
HappyHomeMission6=HappyHomeMission6
OdekakeTutorial=OdekakeTutorial
OdekakeTutorialKeyword=OdekakeTutorialKeyword
RcoGotWorkingwear=RcoGotWorkingwear
RcoHeardWorkExplain1=RcoHeardWorkExplain1
RcoHeardWorkExplain2=RcoHeardWorkExplain2
RcoFinishMakingAxe=RcoFinishMakingAxe
OdekakeFirstTalk=OdekakeFirstTalk
OdekakeFirstOpenGate=OdekakeFirstOpenGate
SzaGotDiyRecipe001=SzaGotDiyRecipe001
OwlGotDiyRecipe001=OwlGotDiyRecipe001
TownNewsHeard1st=TownNewsHeard1st
GyroidPlazaTalk1st=GyroidPlazaTalk1st
PlayerLoanRepaying=PlayerLoanRepaying
PlayerLoanFinish1st=PlayerLoanFinish1st
RcoHeardRemodel1=RcoHeardRemodel1
UsedCoinStone=UsedCoinStone
OwlFinished1stTalk=OwlFinished1stTalk
OwlTalkDuringConst1=OwlTalkDuringConst1
OwlDonationDone=OwlDonationDone
Owl1stTalkMuseum1=Owl1stTalkMuseum1
EnableEmoticonUI=EnableEmoticonUI
RcoDoneDIYmyself=RcoDoneDIYmyself
RcoOrderedHouseBuilt=RcoOrderedHouseBuilt
RcmHeardAboutRenual=RcmHeardAboutRenual
RcmHeardAboutNewOpen1=RcmHeardAboutNewOpen1
RcmHeardAboutNewOpen2=RcmHeardAboutNewOpen2
ChmTalkRuleFirst=ChmTalkRuleFirst
ChmQuestFinish=ChmQuestFinish
ChmTalkPoint_BeforeEv=ChmTalkPoint_BeforeEv
ChmTalkFirst_EvQuestFinish=ChmTalkFirst_EvQuestFinish
ChmTalkFirst_AfterEv=ChmTalkFirst_AfterEv
RcoGotDonationRewardFlower=RcoGotDonationRewardFlower
TownNewsHeardTownHallOpenFlag=TownNewsHeardTownHallOpenFlag
TownNewsHeardShopOpen1Flag=TownNewsHeardShopOpen1Flag
TownNewsHeardShopOpen2Flag=TownNewsHeardShopOpen2Flag
TownNewsHeardMuseumOpenFlag=TownNewsHeardMuseumOpenFlag
MarvelAtCockroarchToday=MarvelAtCockroarchToday
GstTalkBefore=GstTalkBefore
GstQuestStartFlag=GstQuestStartFlag
GstQuestClearFlag=GstQuestClearFlag
GstQuestBreakFlag=GstQuestBreakFlag
MainmenuRecipe=MainmenuRecipe
PurchaseBoxUseTodayFlag=PurchaseBoxUseTodayFlag
TownNewsHeardEventOpen=TownNewsHeardEventOpen
PostHasNewMessage=PostHasNewMessage
EnablePcTownDecoration=EnablePcTownDecoration
KaburibaConditionFlag=KaburibaConditionFlag
SzaHeardSonkatsuExplain=SzaHeardSonkatsuExplain
SzaHeardMuraokoshiExplain=SzaHeardMuraokoshiExplain
SzaHeardAboutHousingKit=SzaHeardAboutHousingKit
SeoFirstFlag=SeoFirstFlag
FoxTalkTodayFlag=FoxTalkTodayFlag
FoxBuyTodayFlag=FoxBuyTodayFlag
FoxBuyArtTodayFlag=FoxBuyArtTodayFlag
TownNewsHeardEventSpaceOpenFlag=TownNewsHeardEventSpaceOpenFlag
PcDidNotKnowKK=PcDidNotKnowKK
RcoAfterHouseRemodel=RcoAfterHouseRemodel
HeardAboutBuildingTownOffice=HeardAboutBuildingTownOffice
RcoFenceShoppingExplain=RcoFenceShoppingExplain
Ttl1stmet=Ttl1stmet
PcTownmakeLv=PcTownmakeLv
PcUpgradeTownmakeToday=PcUpgradeTownmakeToday
PcHousingLoanFinish=PcHousingLoanFinish
RcoGetTvForCongratsHouse=RcoGetTvForCongratsHouse
RcoItemFullForTv=RcoItemFullForTv
PlayerEnableEating=PlayerEnableEating
PlayerStungByBee=PlayerStungByBee
GetEmoticonTodayFlag=GetEmoticonTodayFlag
BevTalkRuleFirst=BevTalkRuleFirst
BevQuestFinish=BevQuestFinish
BevTalkPoint_BeforeEv=BevTalkPoint_BeforeEv
BevTalkFirst_EvQuestFinish=BevTalkFirst_EvQuestFinish
BevTalkFirst_AfterEv=BevTalkFirst_AfterEv
TutorialFinishAndPast1day=TutorialFinishAndPast1day
HasGottenToolChangeStick=HasGottenToolChangeStick
GetBirthdayTable=GetBirthdayTable
GetBirthdayCandle=GetBirthdayCandle
GetBirthdayHat=GetBirthdayHat
GetBirthdayBoard=GetBirthdayBoard
GetBirthdaySunglasses=GetBirthdaySunglasses
MainUiClockEnable=MainUiClockEnable
PrologueAfterBuiltTentTalk=PrologueAfterBuiltTentTalk
PrologueForCampfire1=PrologueForCampfire1
PlayerPickupEnable=PlayerPickupEnable
HaveTownFruit4CampFire=HaveTownFruit4CampFire
PrologueForCampfire2=PrologueForCampfire2
SzaTalkBeforeCountdown=SzaTalkBeforeCountdown
SzaTalkAfterCountdown=SzaTalkAfterCountdown
SzaGotNewYearHat=SzaGotNewYearHat
SzaGotCracker=SzaGotCracker
PrologueStartedCampfire=PrologueStartedCampfire
AllowPcTentEntering=AllowPcTentEntering
TkkTalkToday=TkkTalkToday
TkkLiveToday=TkkLiveToday
PcMaingameStart=PcMaingameStart
TkkGetMusicToday=TkkGetMusicToday
MoveNpcTradeSkipCount=MoveNpcTradeSkipCount
RcoTalked1stAfterPrologue=RcoTalked1stAfterPrologue
RcmTalked1stAfterPrologue=RcmTalked1stAfterPrologue
RcoTentAdviceCanceled=RcoTentAdviceCanceled
RcoHeardAboutMyhome=RcoHeardAboutMyhome
PlayerFirstShootDownBalloon=PlayerFirstShootDownBalloon
PrologueFinishTkkDream=PrologueFinishTkkDream
RcoPaid1stCharge=RcoPaid1stCharge
RcoTentEnableDIYtrial=RcoTentEnableDIYtrial
RcoDIYtrialOngoing=RcoDIYtrialOngoing
RcoDIYtrialGetMaterial=RcoDIYtrialGetMaterial
RcoTentDonation=RcoTentDonation
RcoTentDonatinDeclined=RcoTentDonatinDeclined
EnableBuildMuseumTent=EnableBuildMuseumTent
RcoTookRequestMuseum=RcoTookRequestMuseum
DecidedMuseumTentPlace=DecidedMuseumTentPlace
RcoDeclinedMuseumReq=RcoDeclinedMuseumReq
RcmDeclinedQuestReq=RcmDeclinedQuestReq
RcmTookQuestReq=RcmTookQuestReq
JohnnyAnotherPlayerClearFlag=JohnnyAnotherPlayerClearFlag
NnpcFinishHintTalk=NnpcFinishHintTalk
HgsCloseness=HgsCloseness
HgsTalkTodayFlag=HgsTalkTodayFlag
NnpcApproachNoEmoticonCount=NnpcApproachNoEmoticonCount
HgsAllowAddFriendship=HgsAllowAddFriendship
MainmenuCall=MainmenuCall
EmergencyEscapeExplain=EmergencyEscapeExplain
HHAGradeMailFlag=HHAGradeMailFlag
EnableSmatDeviceNortification=EnableSmatDeviceNortification
CatchFishFes_Bonus=CatchFishFes_Bonus
CatchFishFes_CooperativeBonus=CatchFishFes_CooperativeBonus
CatchInsectFes_Bonus=CatchInsectFes_Bonus
CatchInsectFes_CooperativeBonus=CatchInsectFes_CooperativeBonus
LookNpcHouseVisitNpc=LookNpcHouseVisitNpc
MainmenuFriendList=MainmenuFriendList
FriendListMainSwitch=FriendListMainSwitch
SnowmanGotDay1Flag=SnowmanGotDay1Flag
SnowmanGotDay2Flag=SnowmanGotDay2Flag
SnowmanGotDay3Flag=SnowmanGotDay3Flag
SnowmanGotDay4Flag=SnowmanGotDay4Flag
MainmenuOnlineShopping=MainmenuOnlineShopping
MainmenuRndDailyQuest=MainmenuRndDailyQuest
MainmenuAchievement=MainmenuAchievement
SnowmanBuildFlag=SnowmanBuildFlag
SnowmanFirstBuildTodayFlag=SnowmanFirstBuildTodayFlag
ObjRcoMachineCheck1st=ObjRcoMachineCheck1st
ReservedNpcGroupActivityMorning=ReservedNpcGroupActivityMorning
ReservedNpcGroupActivityNoon=ReservedNpcGroupActivityNoon
ReservedNpcGroupActivityEvening=ReservedNpcGroupActivityEvening
ReservedNpcGroupActivityNignt=ReservedNpcGroupActivityNignt
RcoMoveHouseReserved=RcoMoveHouseReserved
RcoChangeHouseDesignReserved=RcoChangeHouseDesignReserved
RcoMoveNpcHouseFacilityReserved=RcoMoveNpcHouseFacilityReserved
PlayerSonkatsuQuestEnable=PlayerSonkatsuQuestEnable
RcoMoveShopReserved=RcoMoveShopReserved
RcoMoveMuseumReserved=RcoMoveMuseumReserved
RcoMoveTailorReserved=RcoMoveTailorReserved
ChyDaily_TalkFirst=ChyDaily_TalkFirst
BeyDaily_TalkFirst=BeyDaily_TalkFirst
BeyDaily_QuestClear=BeyDaily_QuestClear
AccessLostPropertyBox1st=AccessLostPropertyBox1st
Mobile1stBoot_Camera=Mobile1stBoot_Camera
Mobile1stBoot_MilageProgram=Mobile1stBoot_MilageProgram
Mobile1stBoot_MilagePlus=Mobile1stBoot_MilagePlus
Mobile1stBoot_Encyclopedia=Mobile1stBoot_Encyclopedia
Mobile1stBoot_DIYrecipe=Mobile1stBoot_DIYrecipe
Mobile1stBoot_OnlineShopping=Mobile1stBoot_OnlineShopping
Mobile1stBoot_Mydesign=Mobile1stBoot_Mydesign
Mobile1stBoot_SharePlay=Mobile1stBoot_SharePlay
Mobile1stBoot_BestFriend=Mobile1stBoot_BestFriend
Mobile1stBoot_Passport=Mobile1stBoot_Passport
Mobile1stBoot_Map=Mobile1stBoot_Map
Mobile1stBoot_SOS=Mobile1stBoot_SOS
RctTalkBeforeFalg=RctTalkBeforeFalg
AmountHeardPublicAnnouncement=AmountHeardPublicAnnouncement
SzaTalkAboutOfficeService=SzaTalkAboutOfficeService
SzaFlowerQuestClear=SzaFlowerQuestClear
RcoTalkAboutBuildBridge=RcoTalkAboutBuildBridge
RcoTalkAboutBuildSlope=RcoTalkAboutBuildSlope
RcoTalkAboutDeleteBridgeSlope=RcoTalkAboutDeleteBridgeSlope
RcoBuildBridgeReserved=RcoBuildBridgeReserved
RcoBuildSlopeReserved=RcoBuildSlopeReserved
RcoDeleteBridgeSlopeReserved=RcoDeleteBridgeSlopeReserved
RcoDeleteSlopeReserved=RcoDeleteSlopeReserved
OwlShowFossilMyself=OwlShowFossilMyself
RcmShowHardWood=RcmShowHardWood
RcoTalkAfterMuseumTent=RcoTalkAfterMuseumTent
PlayerGotHardWood=PlayerGotHardWood
RcmSellCampingStuffReaction=RcmSellCampingStuffReaction
OBJRcoMachineChkPlusEnable=OBJRcoMachineChkPlusEnable
SysCountOpenedToolManual=SysCountOpenedToolManual
RcoHeardThanksForBuiltOwlTent=RcoHeardThanksForBuiltOwlTent
AnnouncementOwlMovedIn=AnnouncementOwlMovedIn
RcmTalkAboutCupboard=RcmTalkAboutCupboard
RcoDonateStatus=RcoDonateStatus
RcoGotLoginBonusToday=RcoGotLoginBonusToday
RcoMachineDailyLoginDays=RcoMachineDailyLoginDays
RcoMachineDailyLoginCheck=RcoMachineDailyLoginCheck
RcoMachineEnableExchange=RcoMachineEnableExchange
JohnnyPartsCount=JohnnyPartsCount
BeyDaily_QuestCount=BeyDaily_QuestCount
TalkRumorPActionTodayAnyone=TalkRumorPActionTodayAnyone
TalkRumorPFavoriteTodayAnyone=TalkRumorPFavoriteTodayAnyone
IsToolShortcutManualOpen=IsToolShortcutManualOpen
RcoMachineExplainAboutPlaneTicket=RcoMachineExplainAboutPlaneTicket
DodExplainAboutMysteryTour=DodExplainAboutMysteryTour
IsGetMessageBottle=IsGetMessageBottle
DodFirstTalkAfterPlusEnable=DodFirstTalkAfterPlusEnable
ImmQHousingKitGetFirst=ImmQHousingKitGetFirst
ImmQFirstExplain=ImmQFirstExplain
ImmQRunningForPlayer=ImmQRunningForPlayer
DodUseFirstFreeTour=DodUseFirstFreeTour
AppUrgentEscapeUseToday=AppUrgentEscapeUseToday
AppUrgentEscapeNoPayment=AppUrgentEscapeNoPayment
ImmQSetHousingAbyMySelf=ImmQSetHousingAbyMySelf
ImmQSetHousingBbyMySelf=ImmQSetHousingBbyMySelf
ImmQSetHousingCbyMySelf=ImmQSetHousingCbyMySelf
ImmQSetOutdoorAbyMySelf=ImmQSetOutdoorAbyMySelf
ImmQSetOutdoorBbyMySelf=ImmQSetOutdoorBbyMySelf
ImmQSetOutdoorCbyMySelf=ImmQSetOutdoorCbyMySelf
RcoHeardNoticeOfficeBuild=RcoHeardNoticeOfficeBuild
RcoTalkBeforeCountdown=RcoTalkBeforeCountdown
RcoTalkAfterCountdown=RcoTalkAfterCountdown
ChyDaily_TalkFirstDay=ChyDaily_TalkFirstDay
ChyDaily_SellCount=ChyDaily_SellCount
ChyDaily_SellFirst=ChyDaily_SellFirst
NetIsRegistHomeLand=NetIsRegistHomeLand
FriendListNotifyUpdate=FriendListNotifyUpdate
FriendListNotifyLook=FriendListNotifyLook
CatchFishContinueCount=CatchFishContinueCount
FriendMailSendEnable=FriendMailSendEnable
BeyDaily_TalkFirstDay=BeyDaily_TalkFirstDay
PrayStarToday=PrayStarToday
StarPieceGrowCount=StarPieceGrowCount
BeyDaily_QuestStart=BeyDaily_QuestStart
KinuyoChkMydesginFlag=KinuyoChkMydesginFlag
HgsGotCloth=HgsGotCloth
RcmDeliver_00=RcmDeliver_00
HasTalkedAllVillagerToday=HasTalkedAllVillagerToday
AmiiboPhoneTalkFirst=AmiiboPhoneTalkFirst
PrintServiceExplain=PrintServiceExplain
SendPuromaidoCount=SendPuromaidoCount
KinuyoTalkInTailorFlag=KinuyoTalkInTailorFlag
KinuyoForcesTalkTodayFlag=KinuyoForcesTalkTodayFlag
KinuyoForcedTalk2TodayFlag=KinuyoForcedTalk2TodayFlag
ChyEvent_TotalPoint=ChyEvent_TotalPoint
BeyEvent_TotalPoint=BeyEvent_TotalPoint
ChyEvent_GetTrophyGold=ChyEvent_GetTrophyGold
ChyEvent_GetTrophySilver=ChyEvent_GetTrophySilver
ChyEvent_GetTrophyCopper=ChyEvent_GetTrophyCopper
BeyEvent_GetTrophyGold=BeyEvent_GetTrophyGold
BeyEvent_GetTrophySilver=BeyEvent_GetTrophySilver
BeyEvent_GetTrophyCopper=BeyEvent_GetTrophyCopper
PurchaseBoxUseOnceFlag=PurchaseBoxUseOnceFlag
BeyDaily_ReqObj=BeyDaily_ReqObj
ChyDaily_ReqObj=ChyDaily_ReqObj
BeyDaily_ExplainReqObj_First=BeyDaily_ExplainReqObj_First
ChyDaily_ExplainReqObj_First=ChyDaily_ExplainReqObj_First
KinuyoTailorBuildFlag=KinuyoTailorBuildFlag
BirthdayPToldlPartySharePlay=BirthdayPToldlPartySharePlay
TalkSnpcTodayAnyone=TalkSnpcTodayAnyone
RcmForcedTalkTodayFlag=RcmForcedTalkTodayFlag
RcmForcedTalk2TodayFlag=RcmForcedTalk2TodayFlag
KinuyoMetShopFlag=KinuyoMetShopFlag
ImmQGetHousingFullItem=ImmQGetHousingFullItem
TownNewsReserve=TownNewsReserve
BeyDaily_ExolainQ_First=BeyDaily_ExolainQ_First
ImmQHeardClearInfoA=ImmQHeardClearInfoA
ImmQHeardClearInfoB=ImmQHeardClearInfoB
ImmQHeardClearInfoC=ImmQHeardClearInfoC
ImmQHeardNoticeRemoveFtr=ImmQHeardNoticeRemoveFtr
RcoImmQClear1QuestToday=RcoImmQClear1QuestToday
ImmQTalkRcoHaveBridgeKit=ImmQTalkRcoHaveBridgeKit
ImmQTalkRcoBridgeKitSet=ImmQTalkRcoBridgeKitSet
ImmQSetBridgeKitMySelf=ImmQSetBridgeKitMySelf
ImmQTalkRcoBridgeComplete=ImmQTalkRcoBridgeComplete
ImmQTalkAboutPrize=ImmQTalkAboutPrize
ImmQGetQuestPrize=ImmQGetQuestPrize
ChyDaily_AnnounceEvent=ChyDaily_AnnounceEvent
BeyDaily_AnnounceEvent=BeyDaily_AnnounceEvent
CampInvite=CampInvite
CampFirstTalk=CampFirstTalk
CampQuestAccept=CampQuestAccept
CampQuestRecipiFailed=CampQuestRecipiFailed
CampQuestRejected=CampQuestRejected
CampGameGetRare=CampGameGetRare
Camp_InduceFailFlag=Camp_InduceFailFlag
Camp_InduceFailSameNpcLiving=Camp_InduceFailSameNpcLiving
Camp_InduceFailSameNpcMoveIn=Camp_InduceFailSameNpcMoveIn
Camp_InduceFailVillagerMax=Camp_InduceFailVillagerMax
Camp_InduceFailSellPlaceNothing=Camp_InduceFailSellPlaceNothing
CalendarEventAchievementFinish=CalendarEventAchievementFinish
RollanGotWallpaperFlag=RollanGotWallpaperFlag
RollanGotCarpetFlag=RollanGotCarpetFlag
ImmQTakeFruit=ImmQTakeFruit
ImmQTakeRemakeKit=ImmQTakeRemakeKit
ImmQBridgeMadeinRcoTent=ImmQBridgeMadeinRcoTent
IslandDevQuestShowCampKit=IslandDevQuestShowCampKit
IslandDevQuestCampMadeRcotent=IslandDevQuestCampMadeRcotent
IslandDevQuestTalkAfterCampSet=IslandDevQuestTalkAfterCampSet
IslandDevQuestCampSetMySelf=IslandDevQuestCampSetMySelf
IslandDevQuestGetRecipeCampKit=IslandDevQuestGetRecipeCampKit
IslandDevQuestOrderFirstCamperMyself=IslandDevQuestOrderFirstCamperMyself
MainmenuConstructLicense=MainmenuConstructLicense
FirstPlayAfterOfficeBuiltFlag=FirstPlayAfterOfficeBuiltFlag
FirstPlayAfterShopBuiltFlag=FirstPlayAfterShopBuiltFlag
FirstPlayAfterShopBuilt2Flag=FirstPlayAfterShopBuilt2Flag
FirstPlayAfterMuseumTentFlag=FirstPlayAfterMuseumTentFlag
FirstPlayAfterMuseumBuiltFlag=FirstPlayAfterMuseumBuiltFlag
FirstPlayAfterTailorBuiltFlag=FirstPlayAfterTailorBuiltFlag
SzaHeardTodayIslandEvaluation=SzaHeardTodayIslandEvaluation
IslandEvaluationUnlockMyself=IslandEvaluationUnlockMyself
SzaHeardAboutIslandEvaluation=SzaHeardAboutIslandEvaluation
ConstructionWorkToday=ConstructionWorkToday
PlayToday=PlayToday
TalkFreeIPresentTodayAnyone=TalkFreeIPresentTodayAnyone
IslandDevQuestTalkAfterBuildCamp=IslandDevQuestTalkAfterBuildCamp
IslandDevQuestTalkAboutFirstCamper=IslandDevQuestTalkAboutFirstCamper
GetHousingKitForFirstCamper=GetHousingKitForFirstCamper
ItemFullHousingKitForFirstCamper=ItemFullHousingKitForFirstCamper
SetHousingKitForFirstCamper=SetHousingKitForFirstCamper
ChyDaily_InsectSellNum=ChyDaily_InsectSellNum
SharePlayGuideDone=SharePlayGuideDone
CommuneIslandAvailable=CommuneIslandAvailable
VisitedCommune=VisitedCommune
ChyEvent_TalkTrophyGold=ChyEvent_TalkTrophyGold
ChyEvent_TalkTrophySilver=ChyEvent_TalkTrophySilver
ChyEvent_TalkTrophyCopper=ChyEvent_TalkTrophyCopper
BeyEvent_TalkTrophyGold=BeyEvent_TalkTrophyGold
BeyEvent_TalkTrophySilver=BeyEvent_TalkTrophySilver
BeyEvent_TalkTrophyCopper=BeyEvent_TalkTrophyCopper
SpnFirstTalkedAtCommuneIsland=SpnFirstTalkedAtCommuneIsland
AppUrgentEscapeCallToday=AppUrgentEscapeCallToday
KotonoGotSampleFlag=KotonoGotSampleFlag
KotonoGotTicketFlag=KotonoGotTicketFlag
OwsFirstTalk=OwsFirstTalk
OwsTalkedToday=OwsTalkedToday
OwsPresentFirstRecipe=OwsPresentFirstRecipe
SpnPhotoStudioGuideDone=SpnPhotoStudioGuideDone
GetBirthdayCake=GetBirthdayCake
GetBirthdayFloorParty=GetBirthdayFloorParty
GetBirthdayWallParty=GetBirthdayWallParty
AddHairStyle1=AddHairStyle1
AddHairStyle2=AddHairStyle2
AddHairStyle3=AddHairStyle3
TanuportAmiiboBromideUnlock=TanuportAmiiboBromideUnlock
AddHairColor=AddHairColor
EnableDiyRemake=EnableDiyRemake
GetLicenseGrdStone=GetLicenseGrdStone
GetLicenseGrdBrick=GetLicenseGrdBrick
GetLicenseGrdDarkSoil=GetLicenseGrdDarkSoil
GetLicenseGrdStonePattern=GetLicenseGrdStonePattern
GetLicenseGrdSand=GetLicenseGrdSand
GetLicenseGrdTile=GetLicenseGrdTile
GetLicenseGrdWood=GetLicenseGrdWood
GetLicenseRiver=GetLicenseRiver
GetLicenseCliff=GetLicenseCliff
EquipLicenseHelmet=EquipLicenseHelmet
OwsPresentTodayRecipe=OwsPresentTodayRecipe
OwsPresentThisZodiacRecipe=OwsPresentThisZodiacRecipe
OwsThisZodiac=OwsThisZodiac
NewYearPlayReportSend=NewYearPlayReportSend
RctOutsideHintToday=RctOutsideHintToday
DecideShopArea=DecideShopArea
HeardEatingHintAtShop=HeardEatingHintAtShop
KinuyoExplainFittingRoomFlag=KinuyoExplainFittingRoomFlag
HasLookMyHouseExplain=HasLookMyHouseExplain
TownNewsHeardRemakeTrialFlag=TownNewsHeardRemakeTrialFlag
RcoEnableRemakeTrial=RcoEnableRemakeTrial
RcoRemakeTrialOngoing=RcoRemakeTrialOngoing
RcoRemakeTrialGetFurniture=RcoRemakeTrialGetFurniture
RcoTalkAboutRemakeTrial=RcoTalkAboutRemakeTrial
RcoStayMyHouseImmQClear=RcoStayMyHouseImmQClear
1stPresentHatType=1stPresentHatType
DodHeardAboutMileTravelTicket=DodHeardAboutMileTravelTicket
DocMysterytourExplain1st=DocMysterytourExplain1st
CampGameClear=CampGameClear
RctTnx4CollectingMaterials=RctTnx4CollectingMaterials
RctTnx4CollectingMaterials2=RctTnx4CollectingMaterials2
RctTnx4ConfirmingStorePlace=RctTnx4ConfirmingStorePlace
RcoFinishAdvice=RcoFinishAdvice
RumorPFavoriteProgressDays=RumorPFavoriteProgressDays
PAnnounceExplainCeremony=PAnnounceExplainCeremony
PAnnounceTailorBuilt=PAnnounceTailorBuilt
RctHintCongratsMyhome=RctHintCongratsMyhome
PAnnounceCampsite=PAnnounceCampsite
PAnnounceHeardOfficeRenual=PAnnounceHeardOfficeRenual
RcoFirstTalkNewOffice=RcoFirstTalkNewOffice
ItemRingEnable=ItemRingEnable
RcoTalkAboutOfficeWork=RcoTalkAboutOfficeWork
TwinTurnipExplanation=TwinTurnipExplanation
HeldCeremonyMarket1=HeldCeremonyMarket1
HeldCeremonyMarket2=HeldCeremonyMarket2
HerdCeremonyOffice=HerdCeremonyOffice
HeldCeremonyMuseum=HeldCeremonyMuseum
HeldCeremonyTailor=HeldCeremonyTailor
HeldCeremonyCampSite=HeldCeremonyCampSite
HeldCeremonyBridge=HeldCeremonyBridge
HeldCeremonySlope=HeldCeremonySlope
HghPeddlerPurchaceToday=HghPeddlerPurchaceToday
RollanBuyWallpaperCount=RollanBuyWallpaperCount
RollanBuyCarpetCount=RollanBuyCarpetCount
RcoTalkAboutMoveBuilding=RcoTalkAboutMoveBuilding
UseMigrantHousingKit1st=UseMigrantHousingKit1st
RcoHeardLadderExplain=RcoHeardLadderExplain
RcoReciveMigrantEvPhone1st=RcoReciveMigrantEvPhone1st
SzaTalkAboutIncresePopulation=SzaTalkAboutIncresePopulation
RcoMoveCampSiteReserved=RcoMoveCampSiteReserved
SkkPurchaseToday=SkkPurchaseToday
SkkTalkTodayFlag=SkkTalkTodayFlag
TkkFirstLiveJoined=TkkFirstLiveJoined
FirstPlayAfterPlayerMake=FirstPlayAfterPlayerMake
RcoMigrantProgressTalk1st=RcoMigrantProgressTalk1st
DodTodayFlightMileGet=DodTodayFlightMileGet
PAnnouceHeardRemakeWsNewsToday=PAnnouceHeardRemakeWsNewsToday
HghGetTailorHousingKit=HghGetTailorHousingKit
SzaTalkAboutIncreseHousingKit=SzaTalkAboutIncreseHousingKit
HghHeardRequestHousingKit=HghHeardRequestHousingKit
HghEndRequestHousingKit=HghEndRequestHousingKit
OfficeSzaIntroduction=OfficeSzaIntroduction
PAnnouceHeardKkProject=PAnnouceHeardKkProject
RcoHeardAboutKkProject1st=RcoHeardAboutKkProject1st
GetLicenseGrdMydesign=GetLicenseGrdMydesign
RcoHeardAbout1stCamperToday=RcoHeardAbout1stCamperToday
RcoHeardAboutEvaluationStart=RcoHeardAboutEvaluationStart
RcoHeardAboutEvalutationDetail=RcoHeardAboutEvalutationDetail
RcoAwaitingExplanation=RcoAwaitingExplanation
SzaHeardAboutEvaluationDetail=SzaHeardAboutEvaluationDetail
PopDiyGoldFromStoneToday=PopDiyGoldFromStoneToday
BeyEvent_TalkFirst=BeyEvent_TalkFirst
AppUrgentEscapeMobCounter=AppUrgentEscapeMobCounter
AppUrgentEscapeTodayShiftMob=AppUrgentEscapeTodayShiftMob
GotMedicineRecipe=GotMedicineRecipe
MessageCardPayment=MessageCardPayment
PlayerHalfAsleepDemoFlag=PlayerHalfAsleepDemoFlag
ChyEvent_TalkFirst=ChyEvent_TalkFirst
RcoWallFtrRemoveHouseRemodel=RcoWallFtrRemoveHouseRemodel
LegacyMyDesignDLEnable=LegacyMyDesignDLEnable
Got2ndLoach=Got2ndLoach
PlayReportDaily=PlayReportDaily
RemakeWs_TalkWhenItemFull=RemakeWs_TalkWhenItemFull
ImmQCompleteDemo=ImmQCompleteDemo
DodSelectCommune1st=DodSelectCommune1st
SpnTalkAtHomelandToday=SpnTalkAtHomelandToday
SpnTalkAtCommuneToday=SpnTalkAtCommuneToday
UpgradePocket30=UpgradePocket30
UpgradePocket40=UpgradePocket40
IllegalReportCount=IllegalReportCount
SellPocket40=SellPocket40
BeyDaily_GetDemo_Clear=BeyDaily_GetDemo_Clear
OpenDIYRecipeEtcCategory=OpenDIYRecipeEtcCategory
RcoBuildBridgeSlopeMyself=RcoBuildBridgeSlopeMyself
RcoRemoveBridgeSlopeMyself=RcoRemoveBridgeSlopeMyself
RcoTalkAboutBuildBridgeSlope=RcoTalkAboutBuildBridgeSlope
RcoTalkAboutHaniwa=RcoTalkAboutHaniwa
PAnnounceHintRnd=PAnnounceHintRnd
PickUpFirst=PickUpFirst
StandByGameStartPhoneCall=StandByGameStartPhoneCall
StandByPhoneCallPrintService=StandByPhoneCallPrintService
StandByPhoneCallSharePlay=StandByPhoneCallSharePlay
StandByPhoneCallPurchaseBox=StandByPhoneCallPurchaseBox
HeardAboutFreeDKeywordA=HeardAboutFreeDKeywordA
HeardAboutFreeDKeywordB=HeardAboutFreeDKeywordB
HeardAboutFreeDKeywordC=HeardAboutFreeDKeywordC
RcoMoveSomeBuiding=RcoMoveSomeBuiding
BuiltMyHome=BuiltMyHome
RcoMoveHousingSetSomeBuild=RcoMoveHousingSetSomeBuild
SzaIslandEvaluation5star1st=SzaIslandEvaluation5star1st
JohnnySitUpBeforeFlag=JohnnySitUpBeforeFlag
CampFirstTalk_FirstVisitor=CampFirstTalk_FirstVisitor
BocAllowAddBuyCount=BocAllowAddBuyCount
BocBuyCount=BocBuyCount
BocBuyNumCount=BocBuyNumCount
EmoticonLastLearnVillagerIndex=EmoticonLastLearnVillagerIndex
MainmenuUnlockMydesingPro=MainmenuUnlockMydesingPro
HeardCurrentPlayerActivityInfo=HeardCurrentPlayerActivityInfo
HeardPreviousPlayerActivityInfo=HeardPreviousPlayerActivityInfo
DodPresentCounter=DodPresentCounter
DodPresentCounterToday=DodPresentCounterToday
DodSingleFlightToday=DodSingleFlightToday
DodPresentSendCounter=DodPresentSendCounter
BDayMsgSenderSNpcUniqueID0=BDayMsgSenderSNpcUniqueID0
BDayMsgSenderSNpcUniqueID1=BDayMsgSenderSNpcUniqueID1
BDayMsgSenderNNpcUniqueID0=BDayMsgSenderNNpcUniqueID0
BDayMsgSenderNNpcUniqueID1=BDayMsgSenderNNpcUniqueID1
BDayMsgRandomSead=BDayMsgRandomSead
UnlockMyDesignProCategory=UnlockMyDesignProCategory
BalloonShootCountToday=BalloonShootCountToday
ContributedBuildBridgeorSlope=ContributedBuildBridgeorSlope
ContributedTodaysCeremonyBridgeorSlope=ContributedTodaysCeremonyBridgeorSlope
Mobile1stBootAfterUnlockPro_Mydesign=Mobile1stBootAfterUnlockPro_Mydesign
TkkBirthdayMessageFlag=TkkBirthdayMessageFlag
TalkFirstCamperAfterSetHousing=TalkFirstCamperAfterSetHousing
TalkFirstCamperAfterRequestSetHousing=TalkFirstCamperAfterRequestSetHousing
NnpcAppE_Rep_OccuredToday=NnpcAppE_Rep_OccuredToday
SzaPAAccidentCounter=SzaPAAccidentCounter
SzaIslandEvaluationTalkAbout1Star=SzaIslandEvaluationTalkAbout1Star
SzaIslandEvaluationHeardToday=SzaIslandEvaluationHeardToday
DailyQuestFivePointDay=DailyQuestFivePointDay
DailyQuestFirstFivePoint=DailyQuestFirstFivePoint
DailyQuestFivePointMiss=DailyQuestFivePointMiss
DailyQuestFivePointQuest=DailyQuestFivePointQuest
DailyQuestFirstFivePointToday=DailyQuestFirstFivePointToday
DailyQuestFivePointSelect=DailyQuestFivePointSelect
AppE_WelcomoMigrants_Occured=AppE_WelcomoMigrants_Occured
BeyEvent_ResultGetFish=BeyEvent_ResultGetFish
ChyEvent_ResultGetInsect=ChyEvent_ResultGetInsect
KotonoKateTalkFlag=KotonoKateTalkFlag
BeyEvent_ResultGetPoint=BeyEvent_ResultGetPoint
ChyEvent_ResultGetPoint=ChyEvent_ResultGetPoint
PhoneCallByRcm=PhoneCallByRcm
PhoneCallByRct=PhoneCallByRct
ThisPCcreatedbeforeOfficeUpgrading=ThisPCcreatedbeforeOfficeUpgrading
RcoMachineAmiiboCamperUnlock=RcoMachineAmiiboCamperUnlock
ObjRcoMachineHeardExplanation=ObjRcoMachineHeardExplanation
OwlHeardInsectExplanation=OwlHeardInsectExplanation
OwlEverDonatedInsect=OwlEverDonatedInsect
2P_CreatedAfterOwlMoving=2P_CreatedAfterOwlMoving
OwlGotDiyRecipe=OwlGotDiyRecipe
RcoTalkAboutMoveMyHome=RcoTalkAboutMoveMyHome
RcoPAnnounceMuseumSP=RcoPAnnounceMuseumSP
PAnnounceHeardMarketUpgradeInfo=PAnnounceHeardMarketUpgradeInfo
PAnnounceHeardMarketUpgradeInfoSza=PAnnounceHeardMarketUpgradeInfoSza
NoticeAboutLicenseRiver=NoticeAboutLicenseRiver
NoticeAboutLicenseCliff=NoticeAboutLicenseCliff
OdekakeFirstInternet=OdekakeFirstInternet
UploadProfileGrowupDaily=UploadProfileGrowupDaily
GoldenBalloonCount=GoldenBalloonCount
GoldenAxeLearningCount=GoldenAxeLearningCount
LastUseLicense=LastUseLicense
GoldenRodRecipeSent=GoldenRodRecipeSent
GoldenNetRecipeSent=GoldenNetRecipeSent
CompleteFish=CompleteFish
CompleteInsects=CompleteInsects
Experienced3starEvaluation=Experienced3starEvaluation
CountGotTrash=CountGotTrash
CountGotTrash_Can=CountGotTrash_Can
CountGotTrash_Tire=CountGotTrash_Tire
JohnnyHelpCount=JohnnyHelpCount
CatchtFesBox_Valid=CatchtFesBox_Valid
TreasurePlayerWin=TreasurePlayerWin
PAnnounce_SummerShell=PAnnounce_SummerShell
PAnnounce_AutumnNuts=PAnnounce_AutumnNuts
UploadPlayerProfileIllegal=UploadPlayerProfileIllegal
PAnnounce_AutumnMushroom=PAnnounce_AutumnMushroom
PAnnounce_WinterSnowFlake=PAnnounce_WinterSnowFlake
PAnnounce_WinterSnowball=PAnnounce_WinterSnowball
PAnnounce_WinterOrnament=PAnnounce_WinterOrnament
NotStartImmQByDIYDisable=NotStartImmQByDIYDisable
PAnnounce_AutumnRedLeaf=PAnnounce_AutumnRedLeaf
PAnnounce_SpringSakura=PAnnounce_SpringSakura
PAnnounce_SpringBamboo=PAnnounce_SpringBamboo
RcoHeardInviteRemakeWS=RcoHeardInviteRemakeWS
KinuyoPROdesginFlag=KinuyoPROdesginFlag
NoticeAboutMydesingOnWorkBench=NoticeAboutMydesingOnWorkBench
LatestMysteryTourUniqueID=LatestMysteryTourUniqueID
OwlMultiDonateExplain=OwlMultiDonateExplain
StandByPhoneCallIslandCreater=StandByPhoneCallIslandCreater
PastDaysFromLastPlay=PastDaysFromLastPlay
UncollectedTreasure=UncollectedTreasure
VisitMysteryTourID11=VisitMysteryTourID11
VisitMysteryTourID12=VisitMysteryTourID12
VisitMysteryTourID13=VisitMysteryTourID13
VisitMysteryTourID14=VisitMysteryTourID14
VisitMysteryTourID16=VisitMysteryTourID16
VisitMysteryTourID17=VisitMysteryTourID17
VisitMysteryTourID19=VisitMysteryTourID19
VisitMysteryTourID21=VisitMysteryTourID21
VisitMysteryTourID24=VisitMysteryTourID24
FriendMailGuideRetentionPeriod=FriendMailGuideRetentionPeriod
StandByRcoVisitMyHomeAfterTkkFirstLive=StandByRcoVisitMyHomeAfterTkkFirstLive
SpnTalkBeforeGotHouseToday=SpnTalkBeforeGotHouseToday
TodayGrowUp=TodayGrowUp
KotonoQuestClearCount=KotonoQuestClearCount
PhotoStudioUseCantCallAmiibo=PhotoStudioUseCantCallAmiibo
ChyDaily_ObjEntry1=ChyDaily_ObjEntry1
ChyDaily_ObjEntry2=ChyDaily_ObjEntry2
ChyDaily_ObjEntry3=ChyDaily_ObjEntry3
BeyDaily_ObjEntry1=BeyDaily_ObjEntry1
BeyDaily_ObjEntry2=BeyDaily_ObjEntry2
BeyDaily_ObjEntry3=BeyDaily_ObjEntry3
BeyDaily_TalkAlways1=BeyDaily_TalkAlways1
BeyDaily_TalkAlways2=BeyDaily_TalkAlways2
BeyDaily_TalkAlways3=BeyDaily_TalkAlways3
CampQuestRecipeGet=CampQuestRecipeGet
Mobile1stBoot_IslandCreater=Mobile1stBoot_IslandCreater
Closet_Explain_ChangeStick=Closet_Explain_ChangeStick
TkkFirstLiveToday=TkkFirstLiveToday
1stBootIslandCreaterCleanService=1stBootIslandCreaterCleanService
MarketBuiltMyVillage=MarketBuiltMyVillage
Mobile1stBootUnlockCantEditMydesign=Mobile1stBootUnlockCantEditMydesign
DodHeardAboutIslandCreator=DodHeardAboutIslandCreator
SzaBeforeIslandEvaluation=SzaBeforeIslandEvaluation
PAnnouceProcessDoneToday=PAnnouceProcessDoneToday
ImprovePlayerProfile=ImprovePlayerProfile
EnableInviteMoveoutNPC=EnableInviteMoveoutNPC
TodayMainGrowUp=TodayMainGrowUp
SzaTalkAtOfficeToday=SzaTalkAtOfficeToday
MainmenuChatLog=MainmenuChatLog
Mobile1stBoot_ChatLog=Mobile1stBoot_ChatLog
Activate_WebService=Activate_WebService
MyDesignExchangeFirstAccess=MyDesignExchangeFirstAccess
MyDesignExchangeUploadOnce=MyDesignExchangeUploadOnce
OhirakiRollbackTutorial=OhirakiRollbackTutorial
SzaTalkFirstNotOffice=SzaTalkFirstNotOffice
Talk1stCamperMultiplay=Talk1stCamperMultiplay
EasterTodayRecipeRandomGenerateNum=EasterTodayRecipeRandomGenerateNum
ObjRcoMachineHeardFenceRecipe=ObjRcoMachineHeardFenceRecipe
WinningProbabilityOfEasterEggGroundRecipe=WinningProbabilityOfEasterEggGroundRecipe
WinningProbabilityOfEasterEggRockRecipe=WinningProbabilityOfEasterEggRockRecipe
WinningProbabilityOfEasterEggLeafRecipe=WinningProbabilityOfEasterEggLeafRecipe
WinningProbabilityOfEasterEggForestRecipe=WinningProbabilityOfEasterEggForestRecipe
WinningProbabilityOfEasterEggSkyRecipe=WinningProbabilityOfEasterEggSkyRecipe
WinningProbabilityOfEasterEggFishRecipe=WinningProbabilityOfEasterEggFishRecipe
ShootDownEasterRecipeBalloon=ShootDownEasterRecipeBalloon
EasterRecipeAddLotNum=EasterRecipeAddLotNum
PynTalkBeforeFlag=PynTalkBeforeFlag
PynTalkBackTodayFlag=PynTalkBackTodayFlag
PynTalkPreVisitDayFlag=PynTalkPreVisitDayFlag
PynTalkEasterDayFlag=PynTalkEasterDayFlag
PynCannotGetItemFlag=PynCannotGetItemFlag
PynExplainExchangeEggsFlag=PynExplainExchangeEggsFlag
PynExplainInventRecipeFlag=PynExplainInventRecipeFlag
PynExplainNnpcRecipeFlag=PynExplainNnpcRecipeFlag
PynGetFirstRecipeEasterDayFlag=PynGetFirstRecipeEasterDayFlag
PynGetFinalMissionRecipeFlag=PynGetFinalMissionRecipeFlag
PynCompleteDiyMissionFlag=PynCompleteDiyMissionFlag
PynGetEggBasketFlag=PynGetEggBasketFlag
PynExplainEasterDateFlag=PynExplainEasterDateFlag
SetMessageBottleEgg=SetMessageBottleEgg
SetTreeEggLeaf=SetTreeEggLeaf
BuryEggGround=BuryEggGround
IsGetMessageBottleEgg=IsGetMessageBottleEgg
HitMessageBottleEgg=HitMessageBottleEgg
MissMessageBottleEgg=MissMessageBottleEgg
EasterNnpcRecipeCount=EasterNnpcRecipeCount
LastEasterApproachVillagerIndex=LastEasterApproachVillagerIndex
OpenDIYRecipeSeasonCategory=OpenDIYRecipeSeasonCategory
LastPlayEasterYear=LastPlayEasterYear
PynEvent_SendRecipeMail=PynEvent_SendRecipeMail
PynGetPreVisitRecipeFlag=PynGetPreVisitRecipeFlag
PynInventRecipeFlag=PynInventRecipeFlag
SnowmanDIYMailFlag=SnowmanDIYMailFlag
AlwJuneBrideDayCount=AlwJuneBrideDayCount
EasterCannotGetNnpcRecipeFlag=EasterCannotGetNnpcRecipeFlag
AlwJuneBrideQuestStartFlag=AlwJuneBrideQuestStartFlag
AlwJuneBrideQuestClearFlag=AlwJuneBrideQuestClearFlag
StampRallyRunningForPlayer=StampRallyRunningForPlayer
OwlInsectStampRally1=OwlInsectStampRally1
OwlInsectStampRally2=OwlInsectStampRally2
OwlInsectStampRally3=OwlInsectStampRally3
OwlFishStampRally1=OwlFishStampRally1
OwlFishStampRally2=OwlFishStampRally2
OwlFishStampRally3=OwlFishStampRally3
OwlFossilStampRally1=OwlFossilStampRally1
OwlFossilStampRally2=OwlFossilStampRally2
OwlFossilStampRally3=OwlFossilStampRally3
AlpJuneBrideExchangeFlag=AlpJuneBrideExchangeFlag
AlwJuneBrideRemakeOpenFlag=AlwJuneBrideRemakeOpenFlag
MailSendFlag_VersionUp=MailSendFlag_VersionUp
MailSendFlag_BundledEdition=MailSendFlag_BundledEdition
GetMayDayTicket=GetMayDayTicket
PAnnouncePreEaster=PAnnouncePreEaster
ShootDownEasterOverCountRecipeBalloon=ShootDownEasterOverCountRecipeBalloon
RcoEarthDayAnnouncement=RcoEarthDayAnnouncement
RcoEarthDayGetHedge=RcoEarthDayGetHedge
SloTalkAboutHedge=SloTalkAboutHedge
SloBuyCount=SloBuyCount
TalkRumorOVlgFavoriteToday=TalkRumorOVlgFavoriteToday
EasterCompleteFlag=EasterCompleteFlag
PhoneCallPrintServiceDelayFlag=PhoneCallPrintServiceDelayFlag
EarthdayDailyAllClear=EarthdayDailyAllClear
GetCountEasterEggGround=GetCountEasterEggGround
GetCountEasterEggRock=GetCountEasterEggRock
GetCountEasterEggLeaf=GetCountEasterEggLeaf
GetCountEasterEggForest=GetCountEasterEggForest
GetCountEasterEggSky=GetCountEasterEggSky
GetCountEasterEggFish=GetCountEasterEggFish
DodHeardAboutMayDayTravelTicket=DodHeardAboutMayDayTravelTicket
UseMayDayTicket=UseMayDayTicket
OwlShowPaintingMyself=OwlShowPaintingMyself
Owl1stTalkMuseum2=Owl1stTalkMuseum2
OwlPaintingQuestExplain=OwlPaintingQuestExplain
FutaReadyForMuseum2=FutaReadyForMuseum2
HeldCeremonyMuseum2=HeldCeremonyMuseum2
EarthdayDailyClearNum=EarthdayDailyClearNum
OwlShowPaintingBeforeQuest=OwlShowPaintingBeforeQuest
OwlPaintingQuestDeclined=OwlPaintingQuestDeclined
LastIslandRepApproachVillagerIndex=LastIslandRepApproachVillagerIndex
ChangedPermanentNum=ChangedPermanentNum
ClearMayDayTour=ClearMayDayTour
NnpcApproachNoIslandRepCount=NnpcApproachNoIslandRepCount
JuneBridePlacementDataClearFlag=JuneBridePlacementDataClearFlag
SloGetHedge=SloGetHedge
XctGerReward=XctGerReward
SpnJuneBrideClearTalkFrag=SpnJuneBrideClearTalkFrag
AlwJuneBrideTalkBeforeFlag=AlwJuneBrideTalkBeforeFlag
AlpJuneBrideTalkBeforeFlag=AlpJuneBrideTalkBeforeFlag
SpnJuneBrideTalkEventFrag=SpnJuneBrideTalkEventFrag
PynVisitYear=PynVisitYear
PynVisitToday=PynVisitToday
OwlStampPlayed=OwlStampPlayed
OwlStampPocketWasFull=OwlStampPocketWasFull
OwlStampGotInsectReward=OwlStampGotInsectReward
OwlStampGotFishReward=OwlStampGotFishReward
OwlStampGotFossilReward=OwlStampGotFossilReward
DocDeliveryPurchaseExplain=DocDeliveryPurchaseExplain
TalkRumorN2TodayAnyone=TalkRumorN2TodayAnyone
TownNewsHeardMuseum2OpenFlag=TownNewsHeardMuseum2OpenFlag
KinuyoMydesginMachineFlag=KinuyoMydesginMachineFlag
OwlStampGotInsect=OwlStampGotInsect
OwlStampGotFish=OwlStampGotFish
OwlStampGotFossil=OwlStampGotFossil
CompleteEventMayDay=CompleteEventMayDay
AlwJuneBrideDayAlreadyCount=AlwJuneBrideDayAlreadyCount
PAnnounceEarthDay=PAnnounceEarthDay
TipsChatFlag=TipsChatFlag
RcoEarthDayAnnouncementPre=RcoEarthDayAnnouncementPre
FoxPreVisitBuyArtFlag=FoxPreVisitBuyArtFlag
FoxPreVisitWantSellFlag=FoxPreVisitWantSellFlag
SloTalkedToday=SloTalkedToday
CurrentJuneBrideTheme=CurrentJuneBrideTheme
PreviousJuneBrideTheme=PreviousJuneBrideTheme
IsSelectedJuneBrideCuteThisYear=IsSelectedJuneBrideCuteThisYear
IsSelectedJuneBrideChicThisYear=IsSelectedJuneBrideChicThisYear
IsSelectedJuneBrideGardenThisYear=IsSelectedJuneBrideGardenThisYear
LastPlayJuneBrideYear=LastPlayJuneBrideYear
FoxFirstTalkInShipFlag=FoxFirstTalkInShipFlag
FoxInvitedShipFlag=FoxInvitedShipFlag
NoticeAboutSmartPhoneCase=NoticeAboutSmartPhoneCase
AlwJuneBridePleaseShootFlag=AlwJuneBridePleaseShootFlag
OwlPaintingQuestReminder=OwlPaintingQuestReminder
OwlShowDiveFishReport=OwlShowDiveFishReport
DocUsePurchaseServiceFalg=DocUsePurchaseServiceFalg
UsePurchaseBOXFalg=UsePurchaseBOXFalg
FoxForcedTalkTodayFlag=FoxForcedTalkTodayFlag
FoxForcedTalk2TodayFlag=FoxForcedTalk2TodayFlag
EDDIYFlowerWreathOrderYear=EDDIYFlowerWreathOrderYear
EDDIYCorollaOrderYear=EDDIYCorollaOrderYear
OwlStampGotRewardExplain=OwlStampGotRewardExplain
UseNavigationMayDayTour=UseNavigationMayDayTour
FirstPlayAfterMuseumBuilt2Flag=FirstPlayAfterMuseumBuilt2Flag
AlwJuneBrideTotalClearCount=AlwJuneBrideTotalClearCount
SloTalkedWeedFirst=SloTalkedWeedFirst
SpnJuneBrideGetFenceFrag=SpnJuneBrideGetFenceFrag
SpnJuneBrideNotGetFenceTodayFrag=SpnJuneBrideNotGetFenceTodayFrag
JuneBrideBGMHasUnlocked=JuneBrideBGMHasUnlocked
XctFirstTalk=XctFirstTalk
PAnnounceJuneBride=PAnnounceJuneBride
StandByPhoneCallJuneBrideSpn=StandByPhoneCallJuneBrideSpn
AlpJuneBrideGetStickFrag=AlpJuneBrideGetStickFrag
LastApproachVillagerIndex=LastApproachVillagerIndex
StandByPhoneCallJuneBride=StandByPhoneCallJuneBride
OwlExplainDiveFishAfterComp=OwlExplainDiveFishAfterComp
AlwJuneBridePartyTalkFlag=AlwJuneBridePartyTalkFlag
AlwJuneBrideLastDayTalkFlag=AlwJuneBrideLastDayTalkFlag
VisitFriendMileageGet=VisitFriendMileageGet
AlwJuneBrideBalloonFlag=AlwJuneBrideBalloonFlag
GstRichItemFlag=GstRichItemFlag
MyDesignExchangeDiscloseAuthorID=MyDesignExchangeDiscloseAuthorID
TapDiscloseDreamLandID=TapDiscloseDreamLandID
PlayerPocketUIEnableInCommuneIsland=PlayerPocketUIEnableInCommuneIsland
GotoMysteryTour=GotoMysteryTour
EnableGotoRareMysteryTour=EnableGotoRareMysteryTour
VisitMysteryTourID20=VisitMysteryTourID20
PAnnounceStampRally=PAnnounceStampRally
FoxPreVisitBuyArtMaxFlag=FoxPreVisitBuyArtMaxFlag
EDDIYFlowerWreathClearYear=EDDIYFlowerWreathClearYear
EDDIYCorollaClearYear=EDDIYCorollaClearYear
GulBQuestStartFlag=GulBQuestStartFlag
GulBQuestFinishFlag=GulBQuestFinishFlag
GulBTalkBeforeFlag=GulBTalkBeforeFlag
GulBAnotherPlayerClearFlag=GulBAnotherPlayerClearFlag
GulBPartsCount=GulBPartsCount
GulBSitUpBeforeFlag=GulBSitUpBeforeFlag
InducedNpcNum=InducedNpcNum
TalkFreeMultiDayEventTodayFlag=TalkFreeMultiDayEventTodayFlag
EarthDayBonus=EarthDayBonus
TalkVillagerClearToday=TalkVillagerClearToday
EarthDayFirstQuestSystem=EarthDayFirstQuestSystem
EarthDayFirstQuestTalk=EarthDayFirstQuestTalk
SeoExchangeItemToday=SeoExchangeItemToday
MailSendFlag_EarthDayNotice=MailSendFlag_EarthDayNotice
PAnnounceMayDayTour=PAnnounceMayDayTour
DreamFirstExplain=DreamFirstExplain
TapDreamFirstTalk=TapDreamFirstTalk
GulBHelpCount=GulBHelpCount
GulBGetQuestItem=GulBGetQuestItem
HasGottenMarinesuit=HasGottenMarinesuit
SeoFirstmeetingFlag=SeoFirstmeetingFlag
TalkRumorOActionTodayAnyone=TalkRumorOActionTodayAnyone
SzaFireworksTalkTodayA=SzaFireworksTalkTodayA
SzaFireworksTalkTodayB=SzaFireworksTalkTodayB
SzaFireworksRewardToday=SzaFireworksRewardToday
FireworksApproachEnd=FireworksApproachEnd
FireworksApproachNpcIndex=FireworksApproachNpcIndex
FireworksApproachGetFirework=FireworksApproachGetFirework
TapDreamTalkToday=TapDreamTalkToday
TapULFirstExplain=TapULFirstExplain
TapDreamUploadToday=TapDreamUploadToday
TapDreamDeleteToday=TapDreamDeleteToday
PknTalkBeforeFlag=PknTalkBeforeFlag
PknTalkTodayFlag=PknTalkTodayFlag
PknGiveCandyCount=PknGiveCandyCount
PknGetCarriageFlag=PknGetCarriageFlag
PknGetBromideFlag=PknGetBromideFlag
PknGetCarriageRecipeFlag=PknGetCarriageRecipeFlag
OwlPaintingDiveFish=OwlPaintingDiveFish
PAnnounceFireworksSza1=PAnnounceFireworksSza1
RcmBoughtCandyTodayFlag=RcmBoughtCandyTodayFlag
FoxFirstTalkFireworksFlag=FoxFirstTalkFireworksFlag
CharacterCreationFlag=CharacterCreationFlag
PublicAnnouncement_DiveFish=PublicAnnouncement_DiveFish
DiveFish_GetLetter=DiveFish_GetLetter
DiveFishPublic_1day=DiveFishPublic_1day
DiveFishPublic_2day=DiveFishPublic_2day
RcmTalkAboutMarinesuitFlag=RcmTalkAboutMarinesuitFlag
Encylopedia_DiveFishMes=Encylopedia_DiveFishMes
MyDesignExchangeExp_v1_4=MyDesignExchangeExp_v1_4
MyDesignExchangeExp_NormalUsage=MyDesignExchangeExp_NormalUsage
PlayerHouseBuiltToday=PlayerHouseBuiltToday
ReceiveTapBedLetter=ReceiveTapBedLetter
FoxTalkOnlyStandShopFlag=FoxTalkOnlyStandShopFlag
NpcGetCandyTodayFlag=NpcGetCandyTodayFlag
DiveFish_FirstDonation=DiveFish_FirstDonation
TapSendThankyouLetter=TapSendThankyouLetter
PickUpDIYGoldCount=PickUpDIYGoldCount
FireworkCannotGetNnpcItemFlag=FireworkCannotGetNnpcItemFlag
SurpriseVisitCount=SurpriseVisitCount
SurpriseVisitDone=SurpriseVisitDone
GetHalloweenRag=GetHalloweenRag
GetHalloweenWallPaper=GetHalloweenWallPaper
GetHalloweenFloor=GetHalloweenFloor
GetHalloweenStickRecipe=GetHalloweenStickRecipe
GetHalloweenGarland=GetHalloweenGarland
GetHalloweenTableSetting=GetHalloweenTableSetting
GetHalloweenBag=GetHalloweenBag
AddBodyColor=AddBodyColor
AddEyeColor=AddEyeColor
AddCheekColor=AddCheekColor
SaveDataRestoringSettingNotice=SaveDataRestoringSettingNotice
TapTalkAboutMydesignShowcase=TapTalkAboutMydesignShowcase
NpcHalloweenTrickFlag=NpcHalloweenTrickFlag
TapFirstDreamIn=TapFirstDreamIn
TapFirstCheckMydesingShowcase=TapFirstCheckMydesingShowcase
SpecialMakeChanged=SpecialMakeChanged
TalkMakeTodayAnyone=TalkMakeTodayAnyone
RcmExplainCandyFlag=RcmExplainCandyFlag
RcmExplainPumpkinFlag=RcmExplainPumpkinFlag
SzaFireworksSubmitMyDesignToday=SzaFireworksSubmitMyDesignToday
PAnnounceHalloween=PAnnounceHalloween
ExplainPumpkinColorFlag=ExplainPumpkinColorFlag
SloExplainPumpkinSeedingFlag=SloExplainPumpkinSeedingFlag
CalcPastDays=CalcPastDays
PlayerProducedByPlayerMoving=PlayerProducedByPlayerMoving
FireworksLastApproachYear=FireworksLastApproachYear
RcoTalkAboutMovingBelongings=RcoTalkAboutMovingBelongings
RcmRctTalkAboutMovingBelongings=RcmRctTalkAboutMovingBelongings
SloExplainAddVegetable=SloExplainAddVegetable
PocketItemSendRecycleBoxByMoving=PocketItemSendRecycleBoxByMoving
TentItemSendRecycleBoxByMoving=TentItemSendRecycleBoxByMoving
PknTalkLastNoCandyFlag=PknTalkLastNoCandyFlag
NotBuilt2PMyHomeAfterMoving=NotBuilt2PMyHomeAfterMoving
HarvestProgress=HarvestProgress
PknGiveLollipopCount=PknGiveLollipopCount
TapSelWhereAreHere=TapSelWhereAreHere
PknTalkLastNotGetFlag=PknTalkLastNotGetFlag
PknLastGiveCandyFlag=PknLastGiveCandyFlag
PknCompItemCandyFlag=PknCompItemCandyFlag
PknCompItemLollipopFlag=PknCompItemLollipopFlag
PknPumpkingLookChatFlag=PknPumpkingLookChatFlag
Mobile1stBoot_Camera_UnlockKeyGuideOff=Mobile1stBoot_Camera_UnlockKeyGuideOff
GetHalloweenRobe=GetHalloweenRobe
GetHalloweenMask=GetHalloweenMask
PknSendLetterFlag=PknSendLetterFlag
PlayerMovingwithNoBelongings=PlayerMovingwithNoBelongings
NpcGiveCandyCount=NpcGiveCandyCount
GetHalloweenGarlandRecipe=GetHalloweenGarlandRecipe
GetHalloweenTableSettingRecipe=GetHalloweenTableSettingRecipe
NpcTalkLastNotGetFlag=NpcTalkLastNotGetFlag
EnabledEmoticonIrregular=EnabledEmoticonIrregular
CanGetMileTicketTrialForMoving=CanGetMileTicketTrialForMoving
PlayerMovingOrderHouseBuilt=PlayerMovingOrderHouseBuilt
PlayerMovingOrderChangeHouseDesign=PlayerMovingOrderChangeHouseDesign
PlayerMovingOrderHouseMoveInIsland=PlayerMovingOrderHouseMoveInIsland
PlayerMovingAfterHouseRemodel=PlayerMovingAfterHouseRemodel
PlayerMovingAfterLoanFinish=PlayerMovingAfterLoanFinish
TapUnlockFavorite=TapUnlockFavorite
LastPlayHalloweenYear=LastPlayHalloweenYear
PlayerMovingDefaultHouseHasBasement=PlayerMovingDefaultHouseHasBasement
PlayerMovingEnable=PlayerMovingEnable
RemakeWithRcoOfficeBeforeWS=RemakeWithRcoOfficeBeforeWS
RemakeWithRcoTentBeforeWS=RemakeWithRcoTentBeforeWS
IslandCreaterUnlockMoving=IslandCreaterUnlockMoving
AnnounceHalloween=AnnounceHalloween
AnnounceHarvest=AnnounceHarvest
MilageSendLetterFlag=MilageSendLetterFlag
NpcHalloweenGetMirrorFlag=NpcHalloweenGetMirrorFlag
NpcHalloweenCandyHelpFlag=NpcHalloweenCandyHelpFlag
PlayerMovingWithEmoticonUI=PlayerMovingWithEmoticonUI
AddHairStyle4=AddHairStyle4
PknGetItem=PknGetItem
XctGetRewardThisIsland=XctGetRewardThisIsland
HarvestHQDish1P=HarvestHQDish1P
HarvestHQDish2P=HarvestHQDish2P
HarvestHQDish3P=HarvestHQDish3P
HarvestHQDish4P=HarvestHQDish4P
TukTalkFirst=TukTalkFirst
HarvestTalkAboutNextDishProgress=HarvestTalkAboutNextDishProgress
TapUnlockLeaveTap=TapUnlockLeaveTap
HarvestKeepReward=HarvestKeepReward
RewindDays=RewindDays
TukTalkBeforeEvent=TukTalkBeforeEvent
TukTalkAfterEvent=TukTalkAfterEvent
AnnounceBeforeHarvest=AnnounceBeforeHarvest
PasswordIsOld=PasswordIsOld
FishExchangeLoseCount=FishExchangeLoseCount
ReiTalkFirst=ReiTalkFirst
ReiGetReward1=ReiGetReward1
ReiGetReward2=ReiGetReward2
ReiGetReward3=ReiGetReward3
ReiStartQuest1=ReiStartQuest1
ReiStartQuest2=ReiStartQuest2
ReiFinishQuest1=ReiFinishQuest1
AnnouncePreChristmas=AnnouncePreChristmas
SantaMissionNpcIndex1=SantaMissionNpcIndex1
SantaMissionNpcIndex2=SantaMissionNpcIndex2
SantaMissionNpcIndex3=SantaMissionNpcIndex3
ReceiveLeaveTapLetter=ReceiveLeaveTapLetter
RcmExplainToy=RcmExplainToy
PckTalkTodayFlag=PckTalkTodayFlag
ChristmasWreathGetYear=ChristmasWreathGetYear
TukSecretRewardType=TukSecretRewardType
TapUpdatedDreamFirstTalk=TapUpdatedDreamFirstTalk
SzaChristmasOrnament=SzaChristmasOrnament
CheckHarvestFtrInStore=CheckHarvestFtrInStore
ChristmasPresentYear=ChristmasPresentYear
InputApproachBanCount=InputApproachBanCount
PckLookChatFlag=PckLookChatFlag
TukCancel1stRequest=TukCancel1stRequest
ChristmasWrappingGiftFlag=ChristmasWrappingGiftFlag
HarvestRefuseGiveHQFood1=HarvestRefuseGiveHQFood1
HarvestRefuseGiveHQFood2=HarvestRefuseGiveHQFood2
HarvestRefuseGiveHQFood3=HarvestRefuseGiveHQFood3
HarvestRefuseGiveHQFood4=HarvestRefuseGiveHQFood4
HarvestGetHint1=HarvestGetHint1
HarvestGetHint2=HarvestGetHint2
HarvestGetHint3=HarvestGetHint3
HarvestGetHint4=HarvestGetHint4
ChristmasWrappingPresentFlag=ChristmasWrappingPresentFlag
PckRecipeFlag=PckRecipeFlag
RcoStorageExpansionReserved=RcoStorageExpansionReserved
RcoStorageExpansionLevel=RcoStorageExpansionLevel
PlayerMovingReservedStorageExpand=PlayerMovingReservedStorageExpand
MailSend_NoticeStorageExpansion=MailSend_NoticeStorageExpansion
RcoStandbyNoticeStorageExpansion=RcoStandbyNoticeStorageExpansion
ChristmasWreathNoGetFlag=ChristmasWreathNoGetFlag
PckGetItem=PckGetItem
GetCarnivalLight=GetCarnivalLight
GetCarnivalFoodStand=GetCarnivalFoodStand
GetCarnivalstage=GetCarnivalstage
GetCarnivalConfettiMachine=GetCarnivalConfettiMachine
GetCarnivalPercussion=GetCarnivalPercussion
GetCarnivalBalloonLight=GetCarnivalBalloonLight
GetCarnivalUmbrellas=GetCarnivalUmbrellas
GetCarnivalFlag=GetCarnivalFlag
GetCarnivalGarland=GetCarnivalGarland
GetCarnivalFloat=GetCarnivalFloat
PckGiveFurnitureCount=PckGiveFurnitureCount
SloExplainPumpkinColorFlag=SloExplainPumpkinColorFlag
SloExplainAddPumpkinFlag=SloExplainAddPumpkinFlag
TukSecretRewardType3rd=TukSecretRewardType3rd
PckTalkBeforeFlag=PckTalkBeforeFlag
SendNNPCConversationPlayReport=SendNNPCConversationPlayReport
ChristmasPrevPresentItemType=ChristmasPrevPresentItemType
ValentineLetterFlag=ValentineLetterFlag
AnnounceChristmasEve=AnnounceChristmasEve
GetCarnivalFurniture=GetCarnivalFurniture
LastPlayValentineYear=LastPlayValentineYear
PckRecipeTalkFlag=PckRecipeTalkFlag
BuyReactionBook17=BuyReactionBook17
GetCarnivalFurnitureRed=GetCarnivalFurnitureRed
GetCarnivalFurnitureBlue=GetCarnivalFurnitureBlue
GetCarnivalFurnitureGreen=GetCarnivalFurnitureGreen
GetCarnivalFurniturePurple=GetCarnivalFurniturePurple
GetCarnivalFurnitureRainbow=GetCarnivalFurnitureRainbow
PckColorLotteryFlag=PckColorLotteryFlag
RcmChkReactionBook=RcmChkReactionBook
RcmChkCarnivalFtr=RcmChkCarnivalFtr
AnnounceCarnival=AnnounceCarnival
TodayCreateVillage=TodayCreateVillage
TodayPlayerEmigrate=TodayPlayerEmigrate
TkkFirstLive=TkkFirstLive
FinishiPC1Prologue=FinishiPC1Prologue
IsMovingConsultationToPlayer=IsMovingConsultationToPlayer
EnableMarketBuild=EnableMarketBuild
ValidateVillageSave=ValidateVillageSave
FreeEChatTimes=FreeEChatTimes
FreeFChatTimes=FreeFChatTimes
RandomKey=RandomKey
DoneMuseumConstruction=DoneMuseumConstruction
Prologue4BuiltPlayer=Prologue4BuiltPlayer
Plorogue4BuiltMuseum=Plorogue4BuiltMuseum
Prologue4BuiltShop=Prologue4BuiltShop
Prologue4BuiltNpcAN=Prologue4BuiltNpcAN
Prologue4BuiltNpcHA=Prologue4BuiltNpcHA
TodayStartTown1P=TodayStartTown1P
ShopItemSet=ShopItemSet
VillageExtensionLevel2=VillageExtensionLevel2
RcmGotSignboard=RcmGotSignboard
InstalledMarketTentSign=InstalledMarketTentSign
SandBankDisable=SandBankDisable
MarketRemodelingFlag1=MarketRemodelingFlag1
MarketOpen1stDay1=MarketOpen1stDay1
SpotPrologueTimes=SpotPrologueTimes
PlazaDonationMoney=PlazaDonationMoney
PlazaDonationMaterial=PlazaDonationMaterial
PlazaDonationFinish=PlazaDonationFinish
EventPlazaBuilt=EventPlazaBuilt
SzaGotGyroid=SzaGotGyroid
PlazaGyroidBuilt=PlazaGyroidBuilt
MuseumGrowupEnable1=MuseumGrowupEnable1
MuseumConstruction1=MuseumConstruction1
Museum2Built=Museum2Built
Museum2BuiltToday=Museum2BuiltToday
InsectNetHostCatchNumResult=InsectNetHostCatchNumResult
GlobalEventAvailable=GlobalEventAvailable
InsectFesFinished=InsectFesFinished
MarketRemodelingFlag2=MarketRemodelingFlag2
MarketOpen1stDay2=MarketOpen1stDay2
RcoMoveReservedKind=RcoMoveReservedKind
QuestReserveStart=QuestReserveStart
VillageDaysCount=VillageDaysCount
PeddlingAvailableSlo=PeddlingAvailableSlo
MarketBuilt=MarketBuilt
PeddingAvailableBoa=PeddingAvailableBoa
MarketConstruction1=MarketConstruction1
MarketConstruction2=MarketConstruction2
FirstKabuBuy=FirstKabuBuy
FirstKabuPattern=FirstKabuPattern
FoxArtStockCount=FoxArtStockCount
EventPlazaBuiltToday=EventPlazaBuiltToday
CountNnpcHouseSpaceSet=CountNnpcHouseSpaceSet
GlobalEventReady=GlobalEventReady
BirthdayBbsVariation1=BirthdayBbsVariation1
EnableBuildTownOffice=EnableBuildTownOffice
BuiltTownOffice=BuiltTownOffice
BuiltTownOfficeToday=BuiltTownOfficeToday
StartBuildingTownOffice=StartBuildingTownOffice
SzaDonatedItemType=SzaDonatedItemType
SzaDonatedItemCount=SzaDonatedItemCount
IsNpcIncreased=IsNpcIncreased
MuseumBuilt=MuseumBuilt
TailorBuilt=TailorBuilt
IslandKanaType=IslandKanaType
TodayGlobalEventId=TodayGlobalEventId
TodayRegionEventId=TodayRegionEventId
NoncompliantRegionCode=NoncompliantRegionCode
GstTalkAnyone=GstTalkAnyone
OwlFoundFossil=OwlFoundFossil
MarketSellRecipeScoopStick=MarketSellRecipeScoopStick
TailorConstruction1=TailorConstruction1
FishFesFinished=FishFesFinished
HghStayMarket=HghStayMarket
EnableHghStayField=EnableHghStayField
EnableTailorBuild=EnableTailorBuild
TailorReserved=TailorReserved
TailorGetHousingkit=TailorGetHousingkit
ReportedTaiorReserve=ReportedTaiorReserve
CountTailorBuild=CountTailorBuild
NNpcPhoneColorChangeCounter=NNpcPhoneColorChangeCounter
RcoEnableBuyHousingKit=RcoEnableBuyHousingKit
OpeningSeqBGMChangeCounter=OpeningSeqBGMChangeCounter
JohnnySitUpFlag=JohnnySitUpFlag
AllowNpcInterestActivity=AllowNpcInterestActivity
RcoBuildCampsiteOngoing=RcoBuildCampsiteOngoing
RcoBuildCampsiteComplete=RcoBuildCampsiteComplete
RcoMeetFirstVisitorRequest=RcoMeetFirstVisitorRequest
RcoMeetFirstVisitorOngoing=RcoMeetFirstVisitorOngoing
RcoMeetFirstVisitorComplete=RcoMeetFirstVisitorComplete
RcoBuildFirstVisitorsHousingKitOngoing=RcoBuildFirstVisitorsHousingKitOngoing
RcoBuildFirstVisitorsHousingKitComplete=RcoBuildFirstVisitorsHousingKitComplete
DonationAmountForMuseum=DonationAmountForMuseum
OfficeConstruction1=OfficeConstruction1
JohnnyTalkAnyPlayerFlag=JohnnyTalkAnyPlayerFlag
TkkReturn=TkkReturn
FlightBalloonEnable=FlightBalloonEnable
ConfirmedFruit=ConfirmedFruit
RctInTent=RctInTent
GstAppearField=GstAppearField
MuseumTentBuiltToday=MuseumTentBuiltToday
TailorBuiltToday=TailorBuiltToday
VillageExtensionLevel3=VillageExtensionLevel3
RcoBuildBridgeSlopeStatusCounter=RcoBuildBridgeSlopeStatusCounter
RcoMoveReservedAnyone=RcoMoveReservedAnyone
HgcVisitFlagForTailor=HgcVisitFlagForTailor
RcoDeleteBridgeSlopeReservedAnyone=RcoDeleteBridgeSlopeReservedAnyone
RcoBuildBridgeSlopeSelector=RcoBuildBridgeSlopeSelector
RcoIslandRevitilizationRefuse=RcoIslandRevitilizationRefuse
MessageBottleAvailable=MessageBottleAvailable
ImmQ_A_GetHousing=ImmQ_A_GetHousing
ImmQ_B_GetHousing=ImmQ_B_GetHousing
ImmQ_C_GetHousing=ImmQ_C_GetHousing
ImmQ_A_SetHousing=ImmQ_A_SetHousing
ImmQ_B_SetHousing=ImmQ_B_SetHousing
ImmQ_C_SetHousing=ImmQ_C_SetHousing
ImmQ_A_Interior1Donate=ImmQ_A_Interior1Donate
ImmQ_B_Interior1Donate=ImmQ_B_Interior1Donate
ImmQ_C_Interior1Donate=ImmQ_C_Interior1Donate
ImmQ_A_Interior2Donate=ImmQ_A_Interior2Donate
ImmQ_B_Interior2Donate=ImmQ_B_Interior2Donate
ImmQ_C_Interior2Donate=ImmQ_C_Interior2Donate
ImmQ_A_Interior3Donate=ImmQ_A_Interior3Donate
ImmQ_B_Interior3Donate=ImmQ_B_Interior3Donate
ImmQ_C_Interior3Donate=ImmQ_C_Interior3Donate
ImmQ_A_Outdoor1Set=ImmQ_A_Outdoor1Set
ImmQ_B_Outdoor1Set=ImmQ_B_Outdoor1Set
ImmQ_C_Outdoor1Set=ImmQ_C_Outdoor1Set
ImmQ_A_Outdoor2Set=ImmQ_A_Outdoor2Set
ImmQ_B_Outdoor2Set=ImmQ_B_Outdoor2Set
ImmQ_C_Outdoor2Set=ImmQ_C_Outdoor2Set
ImmQ_A_Outdoor3Set=ImmQ_A_Outdoor3Set
ImmQ_B_Outdoor3Set=ImmQ_B_Outdoor3Set
ImmQ_C_Outdoor3Set=ImmQ_C_Outdoor3Set
ImmQ_A_Complete=ImmQ_A_Complete
ImmQ_B_Complete=ImmQ_B_Complete
ImmQ_C_Complete=ImmQ_C_Complete
ImmQ_A_Invited=ImmQ_A_Invited
ImmQ_B_Invited=ImmQ_B_Invited
ImmQ_C_Invited=ImmQ_C_Invited
RcmImmQuestOpen=RcmImmQuestOpen
RcmImmQuestRunning=RcmImmQuestRunning
RcmImmQuestComplete=RcmImmQuestComplete
JohnnyRequirePartsNum=JohnnyRequirePartsNum
ImmQ_A_InteriorDonateNow=ImmQ_A_InteriorDonateNow
ImmQ_B_InteriorDonateNow=ImmQ_B_InteriorDonateNow
ImmQ_C_InteriorDonateNow=ImmQ_C_InteriorDonateNow
RcoRemoveBridgeSlopeSelector=RcoRemoveBridgeSlopeSelector
CeremonySlopeUnitX=CeremonySlopeUnitX
CeremonySlopeUnitZ=CeremonySlopeUnitZ
RcoNoticeBuildInfomationOffice=RcoNoticeBuildInfomationOffice
CampSiteBuilt=CampSiteBuilt
RcoDeleteBridgeSlopeBuildPlayer=RcoDeleteBridgeSlopeBuildPlayer
VisitorPrayStarToday=VisitorPrayStarToday
AmiiboCampSiteCall=AmiiboCampSiteCall
ImmQ_SetBridge=ImmQ_SetBridge
CampQuestInProgress=CampQuestInProgress
CampQuestClear=CampQuestClear
SzaTaled1stTimeAnyPlayer=SzaTaled1stTimeAnyPlayer
CeremonyBridgeUnitX=CeremonyBridgeUnitX
CeremonyBridgeUnitZ=CeremonyBridgeUnitZ
CeremonyBuildCampSite=CeremonyBuildCampSite
CeremonyBuildTailor=CeremonyBuildTailor
CeremonyBuildBridge=CeremonyBuildBridge
CeremonyBuildSlope=CeremonyBuildSlope
IslandDevQuestRunning=IslandDevQuestRunning
IslandDevQuestComplete=IslandDevQuestComplete
CountTailorAfterBuild=CountTailorAfterBuild
CountMuseumAfterBuild=CountMuseumAfterBuild
CountMarket1AfterBuild=CountMarket1AfterBuild
CountMarket2AfterBuild=CountMarket2AfterBuild
CountOfficeAfterBuild=CountOfficeAfterBuild
CountFirstBridgeAfterBuild=CountFirstBridgeAfterBuild
CountFirstSlopeAfterBuild=CountFirstSlopeAfterBuild
IslandEvaluationUnlock=IslandEvaluationUnlock
IslandEvaluationClearTkkLive=IslandEvaluationClearTkkLive
HaveHousingKitCount=HaveHousingKitCount
BridgeBuilt=BridgeBuilt
SlopeBuilt=SlopeBuilt
BeyRequireFishSize=BeyRequireFishSize
TanuportAmiiboUnlock=TanuportAmiiboUnlock
SpnVisitMainField=SpnVisitMainField
ChangePlazaFtrToNormal=ChangePlazaFtrToNormal
SetPrologueBonfire=SetPrologueBonfire
ImmQ_A_OutdoorPattern=ImmQ_A_OutdoorPattern
ImmQ_B_OutdoorPattern=ImmQ_B_OutdoorPattern
ImmQ_C_OutdoorPattern=ImmQ_C_OutdoorPattern
TkkFirstLiveReserved=TkkFirstLiveReserved
BirthdayBbsVariation2=BirthdayBbsVariation2
AllowNpcGroupActivity=AllowNpcGroupActivity
TanuportAmiiboCampUnlock=TanuportAmiiboCampUnlock
PickedUpMessageBottle=PickedUpMessageBottle
CountAppE_RepTalk=CountAppE_RepTalk
FlwLilyGrowCounter=FlwLilyGrowCounter
FlwLilyFirstGrow=FlwLilyFirstGrow
CampFirstCamperVisit=CampFirstCamperVisit
RcmShopMaterial_Wood=RcmShopMaterial_Wood
RcmShopMaterial_HardWood=RcmShopMaterial_HardWood
RcmShopMaterial_SoftWood=RcmShopMaterial_SoftWood
RcmShopMaterial_Iron=RcmShopMaterial_Iron
RcmShopMaterialComplete=RcmShopMaterialComplete
ReportFirstCamperAboutSetHousing=ReportFirstCamperAboutSetHousing
RcoRcmTalkingAboutStoreMaterial=RcoRcmTalkingAboutStoreMaterial
PAnnounceRcoCalling=PAnnounceRcoCalling
PAnnounceCeremony1st=PAnnounceCeremony1st
PAnnounceCeremony1stToday=PAnnounceCeremony1stToday
CampSiteBuiltToday=CampSiteBuiltToday
CountCampSiteAfterBuild=CountCampSiteAfterBuild
IslandLocalFruitApple=IslandLocalFruitApple
IslandLocalFruitOrange=IslandLocalFruitOrange
IslandLocalFruitPear=IslandLocalFruitPear
IslandLocalFruitPeach=IslandLocalFruitPeach
IslandLocalFruitCherry=IslandLocalFruitCherry
PAnnounceKkProject=PAnnounceKkProject
TownNewsHeardEventStarted=TownNewsHeardEventStarted
SzaIslandEvaluationBeforeLife=SzaIslandEvaluationBeforeLife
SzaIslandEvaluationBeforeNatural=SzaIslandEvaluationBeforeNatural
FishNetHostCatchNumResult=FishNetHostCatchNumResult
SzaIslandEvaluationBeforeDevelopment=SzaIslandEvaluationBeforeDevelopment
SzaIslandEvaluationTodayRankUpdate=SzaIslandEvaluationTodayRankUpdate
SzaIslandEvaluationImprovementLifeToday=SzaIslandEvaluationImprovementLifeToday
SzaIslandEvaluationImprovementNaturalToday=SzaIslandEvaluationImprovementNaturalToday
SzaIslandEvaluationImprovementDevelopToday=SzaIslandEvaluationImprovementDevelopToday
AppE_WelcomoMigrants_AN=AppE_WelcomoMigrants_AN
AppE_WelcomoMigrants_HA=AppE_WelcomoMigrants_HA
TkkFirstLiveSubPlayer=TkkFirstLiveSubPlayer
PortableRadioControl=PortableRadioControl
Market2Built=Market2Built
OwlTentExplainFor1P=OwlTentExplainFor1P
MuseumConstructionToday=MuseumConstructionToday
ShopUnlockAxe=ShopUnlockAxe
FinishMuseumPreparation1stDay=FinishMuseumPreparation1stDay
MushroomProbability=MushroomProbability
NNpcContractProbablityAddPoint=NNpcContractProbablityAddPoint
TkkFirstLiveEnable=TkkFirstLiveEnable
ImmQClearNextDay=ImmQClearNextDay
TodayImmQNotClear=TodayImmQNotClear
NpcDIYScheduleSet=NpcDIYScheduleSet
PAnnounceToday=PAnnounceToday
AirportOpen=AirportOpen
AnyGlobalEventFinished=AnyGlobalEventFinished
LostPropertyFound=LostPropertyFound
MuseumFossilComplete=MuseumFossilComplete
InduceInMysteriTourIslandToday=InduceInMysteriTourIslandToday
Tutorial1PTentLightON=Tutorial1PTentLightON
CatchInsectFesGetTotalNum=CatchInsectFesGetTotalNum
CatchFishFesGetTotalNum=CatchFishFesGetTotalNum
JohnnyQuestFinishFlagIsland=JohnnyQuestFinishFlagIsland
CampRandomSelectMoveOutNpc=CampRandomSelectMoveOutNpc
CampFireRemoved=CampFireRemoved
UnlockEaster=UnlockEaster
MuseumConstruction2=MuseumConstruction2
MuseumGrowupEnable2=MuseumGrowupEnable2
OwlWantsPainting=OwlWantsPainting
CampTodaySelectMoveOutNpc=CampTodaySelectMoveOutNpc
Museum3Built=Museum3Built
Museum3BuiltToday=Museum3BuiltToday
CountMuseum2AfterBuild=CountMuseum2AfterBuild
Museum2ConstructionToday=Museum2ConstructionToday
GrowUpAfterPatch1_1=GrowUpAfterPatch1_1
GrowUpAfterPatch1_2=GrowUpAfterPatch1_2
GrowUpAfterPatch1_3=GrowUpAfterPatch1_3
GrowUpAfterPatch1_4=GrowUpAfterPatch1_4
EarthdaySloFirstVisit=EarthdaySloFirstVisit
OwlFoundDiveFish=OwlFoundDiveFish
SloPeddlerPurchaceToday=SloPeddlerPurchaceToday
FoxPreVisitToday=FoxPreVisitToday
AnyPlayerHouseBuilt=AnyPlayerHouseBuilt
MuseumFishStampRackLotID1=MuseumFishStampRackLotID1
MuseumFishStampRackLotID2=MuseumFishStampRackLotID2
MuseumFishStampRackLotID3=MuseumFishStampRackLotID3
MuseumInsectStampRackLotID1=MuseumInsectStampRackLotID1
MuseumInsectStampRackLotID2=MuseumInsectStampRackLotID2
MuseumInsectStampRackLotID3=MuseumInsectStampRackLotID3
MuseumFossilStampRackLotID1=MuseumFossilStampRackLotID1
MuseumFossilStampRackLotID2=MuseumFossilStampRackLotID2
MuseumFossilStampRackLotID3=MuseumFossilStampRackLotID3
AOC_EventFlag_000=AOC_EventFlag_000
AOC_EventFlag_001=AOC_EventFlag_001
FoxPreVisitReserve=FoxPreVisitReserve
FoxMovedToMarket=FoxMovedToMarket
FoxAndShipReserve=FoxAndShipReserve
BCAT_EventFlag_002=BCAT_EventFlag_002
BCAT_EventFlag_004=BCAT_EventFlag_004
BCAT_EventFlag_001=BCAT_EventFlag_001
BCAT_EventFlag_003=BCAT_EventFlag_003
FoxPreVisit1Today=FoxPreVisit1Today
FoxPreVisit2Today=FoxPreVisit2Today
EarthdaySloFirstVisitToday=EarthdaySloFirstVisitToday
IsDreamingBed=IsDreamingBed
UnlockJuneBrideSeq=UnlockJuneBrideSeq
RandomKey1=RandomKey1
RandomKey2=RandomKey2
RandomKey3=RandomKey3
RandomKey4=RandomKey4
FoxPreVisitAlreadyBuyToday=FoxPreVisitAlreadyBuyToday
RcoHasResolvedMoveKitBug=RcoHasResolvedMoveKitBug
TapDreamEnable=TapDreamEnable
GulBVisitEnable=GulBVisitEnable
FireworksAddBbsYear=FireworksAddBbsYear
EnableMyDream=EnableMyDream
JohnnyInvisible=JohnnyInvisible
DreamUploadPlayerHaveCreaterID=DreamUploadPlayerHaveCreaterID
DiveFishNetHostCatchNumResult=DiveFishNetHostCatchNumResult
HalloweenSloVisitYear=HalloweenSloVisitYear
HalloweenSloVisitToday=HalloweenSloVisitToday
GrowUpAfterPatch1_5=GrowUpAfterPatch1_5
NeedUpdatePassword=NeedUpdatePassword
IsHalloweenLessThanThreeDays=IsHalloweenLessThanThreeDays
GrowUpAfterPatch1_6=GrowUpAfterPatch1_6
IslandProducedByPlayerMoving=IslandProducedByPlayerMoving
EventObjFlag0=EventObjFlag0
PlayerMovingEnableShopMaterialCollect=PlayerMovingEnableShopMaterialCollect
SecondPublicAnnouncement=SecondPublicAnnouncement
HarvestAfterTerm=HarvestAfterTerm
FinishTreasureQuestByRollback=FinishTreasureQuestByRollback
HarvestHQDish1Island=HarvestHQDish1Island
HarvestHQDish2Island=HarvestHQDish2Island
HarvestHQDish3Island=HarvestHQDish3Island
HarvestHQDish4Island=HarvestHQDish4Island
IsDisclosedMyDream=IsDisclosedMyDream
HarvestTukIngredient2_2=HarvestTukIngredient2_2
HarvestTukIngredient3_1=HarvestTukIngredient3_1
HarvestTukIngredient3_2=HarvestTukIngredient3_2
HarvestTukIngredient4_2=HarvestTukIngredient4_2
HarvestTukHideIngredient2_1=HarvestTukHideIngredient2_1
HarvestTukHideIngredient2_2=HarvestTukHideIngredient2_2
ReputaionMyIsland=ReputaionMyIsland
LastPlayXmasYear=LastPlayXmasYear
ShopSelectChristmasFtr=ShopSelectChristmasFtr
IsUploadDisclosedMyDream=IsUploadDisclosedMyDream
TkkFirstLiveNow=TkkFirstLiveNow
ChristmasFtrFirstRound=ChristmasFtrFirstRound
HarvestFestivalAddBbsYear=HarvestFestivalAddBbsYear
GrowUpAfterPatch1_7=GrowUpAfterPatch1_7
XmasEveAddBbsYear=XmasEveAddBbsYear
BCAT_EventFlag_005=BCAT_EventFlag_005
RandomKey5=RandomKey5
ShopSocksFlag=ShopSocksFlag
ShopHeartChocoSelect=ShopHeartChocoSelect
ShopHeartFlowerSelect=ShopHeartFlowerSelect
RandomKey6=RandomKey6
RandomKey7=RandomKey7
BCAT_EventFlag_006=BCAT_EventFlag_006
BCAT_EventFlag_007=BCAT_EventFlag_007
ValentineAddBbsYear=ValentineAddBbsYear
CarnivalAddBbsYear=CarnivalAddBbsYear
CarnivalNpcFeatherColorDecided=CarnivalNpcFeatherColorDecided
CarnivalEventPlazaNpcWander=CarnivalEventPlazaNpcWander
NnpcHouseLoan=NnpcHouseLoan
NnpcHouseBuildOk=NnpcHouseBuildOk
NnpcHouseBuilt=NnpcHouseBuilt
CoordinateUpdate=CoordinateUpdate
Is3rdNpc=Is3rdNpc
MoveInCompletion=MoveInCompletion
LastFtrNum=LastFtrNum
MoveRoomIndex=MoveRoomIndex
PlayerNamePhrase=PlayerNamePhrase
AbandonedHouse=AbandonedHouse
InputPhrase=InputPhrase
TalkLifeStart1P1st=TalkLifeStart1P1st
FromSettlerQuest=FromSettlerQuest
ChangeFirstWall=ChangeFirstWall
ChangeFirstFloor=ChangeFirstFloor
GetFirstVillagerWallFtr1=GetFirstVillagerWallFtr1
GetFirstVillagerWallFtr2=GetFirstVillagerWallFtr2
UseAudioType=UseAudioType
TalkTransitionTimes=TalkTransitionTimes
FinishTalkTransition=FinishTalkTransition
OutdoorCatnap=OutdoorCatnap
ForceMoveOut=ForceMoveOut
EarlyOrLate=EarlyOrLate
ContinuousNormalDay=ContinuousNormalDay
React1stNpcPresent=React1stNpcPresent
IsReFabricSmartPhone=IsReFabricSmartPhone
MarketBuildingSupport=MarketBuildingSupport
NnpcHouseBuiltToday=NnpcHouseBuiltToday
AppE_Happen1st=AppE_Happen1st
AppE_GetItem1st=AppE_GetItem1st
AppE_Rep_HappenToday=AppE_Rep_HappenToday
AppE_WelcomoMigrants=AppE_WelcomoMigrants
AppE_WelcomeMigrantsToday=AppE_WelcomeMigrantsToday
MoveInOrder=MoveInOrder
EquipEasterWear=EquipEasterWear
ForceMoveOutVillagerIndex=ForceMoveOutVillagerIndex
DisplayJuneBridePresent=DisplayJuneBridePresent
ProgressDaysJuneBrideParty=ProgressDaysJuneBrideParty
EnableConvTalkDaysCount=EnableConvTalkDaysCount
WantIngredients=WantIngredients
BeforeGiveIngredients=BeforeGiveIngredients
BeforeWantIngredients=BeforeWantIngredients
XmasEveWakeUpMinute=XmasEveWakeUpMinute
EquipChristmasWear=EquipChristmasWear
HarvestGiveHint1=HarvestGiveHint1
HarvestGiveHint2=HarvestGiveHint2
HarvestGiveHint3=HarvestGiveHint3
HarvestGiveHint4=HarvestGiveHint4
CarnivalFeatherColor=CarnivalFeatherColor
DisplayValentinePresent=DisplayValentinePresent
HarvestDemoEndWait=HarvestDemoEndWait
WoreNewYearHat=WoreNewYearHat
HarvestDemoStateNow=HarvestDemoStateNow
