MsgBackupCreateLocation=NHSE pu� fare backup automatici se crei una cartella chiamata '{0}' nella stessa cartella dell'eseguibile.
MsgBackupCreateQuestion=Vuoi che NHSE faccia automaticamente un backup dei tuoi dati di salvataggio?
MsgDataSizeMismatchImport=La dimensione del file importato (0x{0:X}) non corrisponde alla dimensione richiesta (0x{1:X}).
MsgDataSizeMismatchRAM=Dimensione letta (0x{0:X}) != Dimensione da scrivere (0x{1:X}).
MsgDataDidNotOriginateFromHost_0=I dati importati non derivano dai dati del Villager0 ({0}).
MsgAskUpdateValues=Aggiornare i valori?
MsgAskContinue=Continuare?
MsgAskWriteAnyway=Vuoi scrivere comunque?
MsgAskExportResultToClipboard=Vuoi copiare i risultati sulla tastiera?
MsgCanceling=Annullamento:
MsgInvalidHexValue=Valore esadecimale sbagliato.
MsgImportDirectoryDoesNotExist=La cartella non esiste!
MsgNoPictureLoaded=Nessun immagine caricata.
MsgSaveDataImportFail=Impossibile aprire la cartella che contiene il file di salvataggio.
MsgSaveDataImportSuggest=Prova a spostarlo in un altra posizione e riaprirlo.
MsgSaveDataExportSuccess=Tutti i dati salvati!
MsgSaveDataExportFail=Impossibile salvare i file nella loro posizione originale.
MsgSaveDataHashesValid=Gli hash sono validi.
MsgSaveDataSizeMismatch=La dimensione del file di salvataggio sembra essere non valida.
MsgMoveOut=Stai cercando di far traslocare il Residente Villager?
MsgMoveOutSuggest=Se si, imposta l'Event Flag (024 - ForceMoveOut) ad 1 cosicch� il Residente Villager sia rimosso dal gioco.
MsgFieldItemRemoveAsk=Sei sicuro di voler rimuovere {0}?
MsgFieldItemRemoveNone=Non � stato rimosso niente (non � stato trovato niente).
MsgFieldItemRemoveCount={0} rimossi dalla mappa.
MsgFieldItemModifyAsk=Sei sicuro di voler {0}?
MsgFieldItemModifyNone=Non � stato modificato niente (non � stato trovato niente).
MsgFieldItemModifyCount={0} Modificati dalla mappa.
MsgFieldItemUnsupportedLayer2Tile=Rilevati elementi Layer2 non supportati.
MsgSysBotInfo=Questo SysBot legge e scrive direttamente la RAM sul tuo gioco quando viene chiamato Leggi/Scrivi.
MsgSysBotRequired=Usare questa funzionalit� richiede i moduli: sys-botbase e sysmodule attivi sulla tua console. La console deve essere nella stessa rete del PC che esegue questo programma.
MsgTerrainSetElevation0=Impostare l'altezza di tutti i tile della mappa a 0?
MsgTerrainSetAll=Impostare tutti i tile della mappa al valore del Tile Editor?
MsgTerrainSetAllSkipExterior=Vuoi saltare acri esterni (spiaggia / scogli)?
MsgVillagerFriendshipMax=Vuoi impostare tutti i ricordi dell'Amicizia dei Residenti Villager a 255?
