MsgBackupCreateLocation=如果您在本程序根目录创建 '{0}' 文件夹，NHSE可以帮您自动备份存档。
MsgBackupCreateQuestion=您希望NHSE自动备份您的存档吗？
MsgDataSizeMismatchImport=导入的文件尺寸(0x{0:X})和必要的文件尺寸(0x{1:X})不匹配。
MsgDataSizeMismatchRAM=读取大小 (0x{0:X}) != 写入大小 (0x{1:X})。
MsgDataDidNotOriginateFromHost_0=导入的数据不是来自Villager0 ({0})的数据。
MsgAskUpdateValues=更新数值？
MsgAskContinue=继续？
MsgAskWriteAnyway=强行写入？
MsgAskExportResultToClipboard=导出结果到剪贴板？
MsgCanceling=取消中:
MsgInvalidHexValue=无效的16进制值。
MsgImportDirectoryDoesNotExist=文件夹不存在！
MsgNoPictureLoaded=没有图片被导入。
MsgSaveDataImportFail=无法打开包含存档的文件夹。
MsgSaveDataImportSuggest=试着剪切到其他位置然后再打开。
MsgSaveDataExportSuccess=已保存全部存档！
MsgSaveDataExportFail=无法将文件保存到其原始位置。
MsgSaveDataHashesValid=哈希校验已通过。
MsgSaveDataSizeMismatch=存档大小似乎不正确。
MsgMoveOut=您想赶走这个岛民吗？
MsgMoveOutSuggest=如果是的话, 把岛民属性值中的 (024 - ForceMoveOut) 设定为 1 岛民就会被游戏自动赶走。
MsgFieldItemRemoveAsk=确定要移除 {0} 吗？
MsgFieldItemRemoveNone=指定的项目没有被移除（未找到）。
MsgFieldItemRemoveCount=从地图中移除了 {0} 个物件。
MsgFieldItemModifyAsk=确定要 {0} 吗？
MsgFieldItemModifyNone=指定的项目没有被修改（未找到）。
MsgFieldItemModifyCount=已在地图上编辑了 {0} 个方格。
MsgFieldItemUnsupportedLayer2Tile=检测到不支持的 Layer2 物品。
MsgSysBotInfo=SysBot在读取/写入被调用时会直接通过RAM读/写到游戏中。
MsgSysBotRequired=使用此功能需要在Switch上运行sys-botbase系统模块。而且您的Switch必须与运行此程序的PC位于同一个网段内。
MsgTerrainSetElevation0=将地图上所有方格的海拔设置为 0？
MsgTerrainSetAll=将地图上所有方格设置为当前方格编辑器中的方格？
MsgTerrainSetAllSkipExterior=要跳过耕地之外的方格吗(沙滩/岩石)？
MsgVillagerFriendshipMax=确定要设定所有岛民的友谊回忆值到255吗？
MsgMoveOutAll=This will check the 'Moving Out' box for all Villagers.
MsgFieldItemNoNHI=No .nhi file selected to import!
MsgVillagerReplaceNoText=Clipboard: No text found! Expected internal villager name.
MsgVillagerReplaceOutdatedSaveFormat=Save file is not up to date with latest villager format. Please update in-game.
MsgVillagerReplaceUnknownName=Clipboard: {0} is not a valid internal villager name.
