MsgBackupCreateLocation=NHSE peut effectuer des sauvegardes automatiques si vous créez un dossier portant le nom «{0}» dans le même dossier que l'exécutable.
MsgBackupCreateQuestion=Souhaitez-vous que NHSE conserve automatiquement une sauvegarde de vos données de sauvegarde?
MsgDataSizeMismatchImport=La taille du fichier importé (0x{0:X}) ne correspond pas à la taille requise (0x{1:X}).
MsgDataSizeMismatchRAM=Taille de lecture (0x{0:X})! = Taille d'écriture (0x{1:X}).
MsgDataDidNotOriginateFromHost_0=Les données importées ne proviennent pas des données de Villager0({0}).
MsgAskUpdateValues=Mettre à jour les valeurs?
MsgAskContinue=Continuer?
MsgAskWriteAnyway=Ecrire quand même?
MsgAskExportResultToClipboard=Exporter les résultats dans le presse-papiers?
MsgAskExportResultsWithFileIndex=Export results with file index at the front of the file name?
MsgCanceling=Annulation de:
MsgInvalidHexValue=Mauvaise valeur hexadécimale.
MsgImportDirectoryDoesNotExist=Le répertoire n'existe pas!
MsgNoPictureLoaded=Aucune image chargée.
MsgSaveDataImportFail=Impossible d'ouvrir le dossier contenant le fichier de sauvegarde.
MsgSaveDataImportSuggest=Essayez de le déplacer vers un autre emplacement et de l'ouvrir à partir de là.
MsgSaveDataExportSuccess=Sauvegardé toutes les données de sauvegarde!
MsgSaveDataExportFail=Impossible d'enregistrer les fichiers dans leur emplacement d'origine.
MsgSaveDataHashesValid=Les hachages sont valides.
MsgSaveDataSizeMismatch=Les tailles des fichiers enregistrés semblent incorrectes.
MsgMoveOut=Essayez-vous de faire déménager le villageois?
MsgMoveOutSuggest=Si tel est le cas, définissez le drapeau d'événement (024 - ForceMoveOut) sur 1 afin que le villageois soit retiré par le jeu.
MsgMoveOutAll=Cela va cocher la case 'Déménager' pour tous les villageois.
MsgFieldItemRemoveAsk=Voulez-vous vraiment supprimer {0}?
MsgFieldItemRemoveNone=Rien de supprimé (aucun trouvé).
MsgFieldItemRemoveCount={0} supprimé de la carte.
MsgFieldItemModifyAsk=Voulez-vous vraiment {0}?
MsgFieldItemModifyNone=Rien de modifié (aucun trouvé).
MsgFieldItemModifyCount=Tuiles {0} modifiées sur la carte.
MsgFieldItemUnsupportedLayer2Tile=Objet "Layer2" non pris en charge détectés.
MsgFieldItemNoNHI=Aucun fichier .nhi sélectionné à importer!
MsgSysBotInfo=Ce SysBot lit et écrit la RAM directement dans votre jeu lorsqu'il est appelé en lecture/écriture.
MsgSysBotRequired=L'utilisation de cette fonctionnalité nécessite le sysmodule sys-botbase exécuté sur la console. Votre console doit être sur le même réseau que le PC exécutant ce programme.
MsgTerrainSetElevation0=Définir l'élévation de toutes les tuiles de la carte sur 0?
MsgTerrainSetAll=Définir la tuile de l'éditeur de Tuiles sur toutes les tuiles de la carte?
MsgTerrainSetAllSkipExterior=Voulez-vous sauter les tuiles dans les acres extérieurs (plage/rochers)?
MsgVillagerFriendshipMax=Voulez-vous définir tous les souvenirs d'amitié villageois sur 255?
MsgVillagerReplaceNoText=Clipboard: Aucun texte trouvé! Nom attendu du villageois interne.
MsgVillagerReplaceOutdatedSaveFormat=Le fichier de sauvegarde n'est pas à jour avec le dernier format de villageois. Veuillez mettre à jour dans le jeu.
MsgVillagerReplaceUnknownName=Presse-papiers: {0} n'est pas un nom de villageois interne valide.
