MsgBackupCreateLocation = NHSE는 실행 파일과 같은 폴더에 이름이 '{0}'인 폴더를 생성하면 자동 백업을 수행 할 수 있습니다.
MsgBackupCreateQuestion = NHSE가 저장 데이터의 백업을 자동으로 유지하도록 하시겠습니까?
MsgDataSizeMismatchImport = 가져온 파일 (0x {0 : X})의 크기가 필요한 크기 (0x {1:X})와 일치하지 않습니다.
MsgDataSizeMismatchRAM = 읽기 크기 (0x {0 : X})! = 쓰기 크기 (0x {1 : X}).
MsgDataDidNotOriginateFromHost_0 = 가져온 데이터는 Villager0 ({0})의 데이터에서 가져온 것이 아닙니다.
MsgAskUpdateValues = 값을 업데이트 하시겠습니까?
MsgAskContinue = 계속 하시겠습니까?
MsgAskWriteAnyway = 그래도 쓰기?
MsgAskExportResultToClipboard = 결과를 클립 보드로 내보내시겠습니까?
MsgCanceling = 취소 :
MsgInvalidHexValue = 잘못된 16 진수 값입니다.
MsgImportDirectoryDoesNotExist = 디렉터리가 없습니다!
MsgNoPictureLoaded =로드 된 사진이 없습니다.
MsgSaveDataImportFail = 저장 파일이 포함 된 폴더를 열 수 없습니다.
MsgSaveDataImportSuggest = 다른 위치로 이동하고 거기에서여십시오.
MsgSaveDataExportSuccess = 모든 저장 데이터를 저장했습니다!
MsgSaveDataExportFail = 파일을 원래 위치에 저장할 수 없습니다.
MsgSaveDataHashesValid = 해시가 유효합니다.
MsgSaveDataSizeMismatch = 저장 파일 크기가 잘못된 것 같습니다.
MsgMoveOut = 주민이 이사하도록하려고합니까?
MsgMoveOutSuggest = 그렇다면 이벤트 플래그 (024-ForceMoveOut)를 1로 설정하여 주민이 게임에서 제거되도록합니다.
MsgFieldItemRemoveAsk = 정말 {0}을 (를) 제거 하시겠습니까?
MsgFieldItemRemoveNone = 제거 된 항목이 없습니다 (없음).
MsgFieldItemRemoveCount =지도에서 {0}을 (를) 제거했습니다.
MsgFieldItemModifyAsk = 정말로 {0} 하시겠습니까?
MsgFieldItemModifyNone = 수정 된 항목이 없습니다 (찾을 수 없음).
MsgFieldItemModifyCount =지도에서 {0} 타일을 수정했습니다.
MsgFieldItemUnsupportedLayer2Tile = 지원되지 않는 Layer2 항목이 감지되었습니다.
MsgSysBotInfo =이 SysBot은 읽기 / 쓰기가 호출 될 때 게임에 직접 RAM을 읽고 씁니다.
MsgSysBotRequired =이 기능을 사용하려면 콘솔에서 실행되는 sys-botbase sysmodule이 필요합니다. 콘솔은이 프로그램을 실행하는 PC와 동일한 네트워크에 있어야합니다.
MsgTerrainSetElevation0 =지도에있는 모든 타일의 고도를 0으로 설정 하시겠습니까?
MsgTerrainSetAll = 타일 편집기의 타일을 맵의 모든 타일로 설정 하시겠습니까?
MsgTerrainSetAllSkipExterior = 외부 에이커 (해변 / 바위)의 타일을 건너 뛰시겠습니까?
MsgVillagerFriendshipMax = 모든 주민 우정 기억을 255로 설정 하시겠습니까?
MsgMoveOutAll = 모든 주민에 대해 '퇴거'상자를 선택합니다.
MsgFieldItemNoNHI = 가져 오기 위해 선택한 .nhi 파일이 없습니다!
MsgVillagerReplaceNoText = 클립 보드 : 텍스트가 없습니다! 내부 주민 이름이 필요합니다.
MsgVillagerReplaceOutdatedSaveFormat = 저장 파일이 최신 주민 형식으로 업데이트되지 않았습니다. 게임 내에서 업데이트하십시오.
MsgVillagerReplaceUnknownName = 클립 보드 : {0}은 (는) 유효한 내부 주민 이름이 아닙니다.
