MsgBackupCreateLocation=NHSE kann automatische Backups durchführen, wenn Sie einen Ordner mit dem Namen '{0}' im selben Ordner wie die ausführbare Datei erstellen.
MsgBackupCreateQuestion=Möchten Sie NHSE, um automatisch ein Backup Ihrer gespeicherten Daten zu erstellen?
MsgDataSizeMismatchImport=Die Größe der importierten Datei (0x{0:X}) entspricht nicht der erforderlichen Größe (0x{1:X}).
MsgDataSizeMismatchRAM=Lesegröße (0x{0:X}) != Schreibgröße (0x{1:X}).
MsgDataDidNotOriginateFromHost_0=Importierte Daten stammen nicht aus den Daten von Villager0 ({0}).
MsgAskUpdateValues=Werte aktualisieren?
MsgAskContinue=Weiter?
MsgAskWriteAnyway=Trotzdem schreiben?
MsgAskExportResultToClipboard=Ergebnisse in die Zwischenablage exportieren?
MsgCanceling=Abbrechen:
MsgInvalidHexValue=Ungültiger Hex-Wert.
MsgImportDirectoryDoesNotExist=Verzeichnis existiert nicht!
MsgNoPictureLoaded=Kein Bild geladen.
MsgSaveDataImportFail=Der Ordner, der die Speicherdatei enthält, kann nicht geöffnet werden.
MsgSaveDataImportSuggest=Versuchen Sie es an einen anderen Ort zu verschieben und von dort aus zu öffnen.
MsgSaveDataExportSuccess=Alle Spielstände gespeichert!
MsgSaveDataExportFail=Dateien können nicht an ihrem ursprünglichen Speicherort gespeichert werden.
MsgSaveDataHashesValid=Hashes sind gültig.
MsgSaveDataSizeMismatch=Speicherdateigrößen scheinen falsch zu sein.
MsgMoveOut=Versuchen Sie, den Dorfbewohner zum Auszug zu bewegen?
MsgMoveOutSuggest=Wenn ja, setze das Event Flag (024 - ForceMoveOut) auf 1, damit der Dorfbewohner vom Spiel entfernt wird.
MsgFieldItemRemoveAsk=Möchten Sie {0} wirklich entfernen?
MsgFieldItemRemoveNone=Nichts entfernt (keine gefunden).
MsgFieldItemRemoveCount={0} von der Karte entfernt.
MsgFieldItemModifyAsk=Möchten Sie wirklich {0}?
MsgFieldItemModifyNone=Nichts geändert (keine gefunden).
MsgFieldItemModifyCount=Modifizierte {0} Kacheln auf der Karte.
MsgFieldItemUnsupportedLayer2Tile=Nicht unterstützte Layer2-Elemente erkannt.
MsgSysBotInfo=Dieser SysBot liest und schreibt RAM direkt in Ihr Spiel, wenn er zum Lesen/Schreiben aufgerufen wird.
MsgSysBotRequired=Die Verwendung dieser Funktionalität erfordert, dass das sys-botbase-Sysmodul auf der Konsole ausgeführt wird. Ihre Konsole muss sich im selben Netzwerk wie der PC befinden, auf dem dieses Programm ausgeführt wird.
MsgTerrainSetElevation0=Die Höhe aller Kacheln auf der Karte auf 0 setzen?
MsgTerrainSetAll=Die Kachel aus dem Kacheleditor auf alle Kacheln auf der Karte setzen?
MsgTerrainSetAllSkipExterior=Möchten Sie die Kacheln im Außenbereich (Strand/Felsen) überspringen?
MsgVillagerFriendshipMax=Möchtest du alle Dorfbewohner-Freundschaftserinnerungen auf 255 setzen?
MsgMoveOutAll=Dadurch wird das 'Auszug'-Kästchen für alle Dorfbewohner markiert.
MsgFieldItemNoNHI=Keine .nhi-Datei zum Importieren ausgewählt!
MsgVillagerReplaceNoText=Zwischenablage: Kein Text gefunden! Erwarteter interner Dorfbewohnername.
MsgVillagerReplaceOutdatedSaveFormat=Speicherdatei entspricht nicht dem neuesten Dorfbewohnerformat. Bitte im Spiel aktualisieren.
MsgVillagerReplaceUnknownName=Zwischenablage: {0} ist kein gültiger interner Dorfbewohnername.
